Ss, Ss, Ss, Sm, Sm, Sm, Sm, Ww, Ww, Ww, Ww, Gd^Fts, Gd^Fts, Gd^Fts, Dd^Edpp, Dd, Dd^Ftd, Dd^Ftd, Ww, Ww, Sm, Hhd, Mdd, Hhd, Hhd, Hhd, Mdd, Hhd, Hhd, Hhd
Ss, Ss, Ss, Sm, Co, Ss, Ss, Ss, Ss^Vhs, Ww, Gd^Fts, Gd^Fts, Dd^Edpp, Dd^Edpp, Dd, Dd^Ftd, Dd^Ftd, Dd^Ftd, Ww, Ww, Sm, Hhd, Mdd, Mdd, Mdd^Xm, Mdd, Mdd^Xm, Mdd, Mdd, Hhd
Ss, Ss, Ss, Co, 4 Ko, Co, Ss, Ss, Sm, Sm, Gd^Fts, Dd^Edpp, Dd, Dd, Dd, Dd^Ftd, Gd^Ftd, Dd^Ftd, Ww, Ww, Ww, Mdd, Mdd, Mdd^Xm, Mdd^Xm, Mdd^Xm, Mdd^Xm, Mdd, Mdd, Hhd
Ss, Ss, Ss, Co, Co, Co, Sm, Ss, Sm, Hhd^Fts, Hhd^Fts, Dd^Edpp, Dd, Dd, Gd^Ftd, Gd^Ftd, Ww, Ww, Sm, Ww, Ww^Vm, Ww, Mdd, Mdd^Xm, Mdd^Xm, Mdd^Xm, Mdd^Xm, Mdd, Mdd, Hhd
Ss, Ss, Ss, Ss, Sm, Sm, Sm, Sm, Sm, Hhd^Fts, Gd^Fts, Gd^Fts, Dd, Dd, Gd^Ftd, Ww, Sm, Sm, Sm, Sm, Hhd^Ftd, Mdd, Mdd, Mdd^Xm, Mdd^Xm, Mdd^Xm, Mdd^Xm, Mdd, Hhd, Hhd
Ss, Ss, Ss, Ss, Sm, Sm, Sm, Sm, Sm, Gd^Fts, Gd^Fts, Dd, Dd, Dd, Gd^Ftd, Ww, Ww, Sm, Ww, Ww, Dd^Ftd, Hhd, Hhd, Mdd, Mdd, Mdd, Mdd, Mdd, Hhd, Dd^Edpp
Ss, Ss, Sm, Sm, Ss, Ss, Ss, Ss, Sm, Gd^Fts, Gd, Dd, Gd, Gd, Dd^Edpp, Dd^Ftd, Gd^Ftd, Ww, Dd^Ftd, Dd^Ftd, Dd, Dd, Dd^Edpp, Hhd, Hhd, Hhd, Hhd, Hhd, Dd^Edpp, Dd^Edpp
Ww, Ss^Vhs, Sm, Sm, Ss, Ss, Ss, Ss, Sm, Gd, Gd, Dd, Dd, Gd, Dd^Edpp, Dd^Edpp, Gd, Gd^Ftd, Dd, Dd, Co, Dd, Dd, Dd^Edpp, Dd^Edpp, Dd^Edpp, Dd^Edpp, Dd^Edpp, Dd^Edpp, Dd^Edpp
Ww, Ww, Sm, Sm, Sm, Ss, Sm, Sm, Gd^Fts, Gd^Fts, Gd, Dd, Dd, Dd^Edpp, Dd^Edpp, Dd^Edpp, Gd, Dd, Dd, Dd, 3 Ko, Dd, Dd, Dd, Dd, Dd^Edpp, Dd^Edpp, Dd^Edpp, Dd, Dd^Edpp
Ww, Ss, Ss, Sm, Sm, Sm, Gd^Fts, Gd^Fts, Gd, Gd, Gd, Gd, Gd, Dd^Edpp, Dd^Edpp, Dd^Edpp, Gd, Dd, Dd, Co, Co, Co, Dd, Dd, Dd, Dd^Edpp, Dd, Dd, Dd, Dd
Ww, Ww, Ss, Sm, Gd^Fts, Gd^Fts, Gd^Fts, Gd^Fts, Gd, Gd, Gd, Gd, Gd, Gd, Dd, Gd^Vhr, Dd, Dd, Dd, Dd, Dd, Dd, Dd, Dd, Dd^Vdt, Dd, Dd^Ftd, Dd, Dd, Dd
Ss, Ww, Ss, Gd^Fts, Gd^Fts, Hhd^Fts, Hhd^Fts, Gd, Gd, Gd, Gd, Gd, Gd, Gd, Gd, Dd, Dd, Dd, Hd, Dd, Dd, Dd, Dd, Dd, Dd^Do, Gd^Efm, Gd^Efm, Dd^Ftd, Dd, Dd
Ss, Ss, Ss, Gd^Fts, Gd^Fts, Hhd^Fts, Hhd^Fts, Gd, Gd^Fts, Gd, Md, Gd^Fts, Gd, Gd, Gd, Gd, Hd, Hd, Mdd, Hd, Hd, Dd, Dd, Gd^Efm, Gd^Efm, Gd^Efm, Gd^Efm, Dd^Ftd, Dd, Dd
Ss, Ss, Ss, Gd^Fts, Gd^Fts, Hhd^Fts, Hhd^Fts, Hhd^Fts, Md, Md, Md, Gd^Fts, Gd, Gd, Gd, Gd, Hd, Mdd, Mdd, Mdd, Hd, Dd, Dd, Gd^Ftd, Gd^Ftd, Gd^Ftd, Rd, Rd, Dd, Dd
Ss, Ss, Gd^Fts, Ss^Vm, Gd^Fts, Gd^Fts, Gd^Fts, Gd^Fts, Md, Md^Vhh, Md, Gd^Fts, Gd, Gd, Hd, Hd, Mdd, Mdd, Mdd, Mdd, Hd, Dd, Dd, Dd, Dd, Dd^Ftd, Dd, Rd, Dd^Edpp, Dd^Edpp
Ss, Ss, Gd^Fts, Gd^Fts, Gd^Fts, Gd^Fts, Gd, Gd^Fts, Gd^Fts, Md, Gd^Fts, Gd^Fts, Gd, Gd, Hd, Mdd, Mdd, Mdd, Mdd, Hd, Dd, Dd, Dd, Dd, Dd, Dd, Dd, Dd, Dd^Edpp, Dd^Edpp
Gd^Fts, Gd^Fts, Gd^Fts, Gd^Fts, Gd^Fts, Gd, Gd, Gd, Gd, Gd^Fts, Gd, Gd, Gd, Gd, Gd, Hd, Hd, Mdd, Hd, Hd, Dd, Dd, Dd^Ftd, Dd^Ftd, Dd^Ftd, Dd, Dd, Dd^Edpp, Dd^Edpp, Dd^Edpp
Gd^Fts, Gd^Fts, Gd^Fts, Gd^Fts, Gd, Gd, Hd, Gd, Gd, Gd, Gd^Eff, Gd, Gd, Gd, Gd, Dd, Dd, Hd, Dd, Dd, Dd, Dd, Dd^Ftd, Dd^Ftd, Dd^Ftd, Dd^Ftd, Rd, Dd, Dd, Dd^Edpp
Gd^Fts, Hhd^Fts, Gd^Fts, Gd^Fts, Gd, Gd, Hd, Hd, Hd, Gd^Gvs, Gd^Gvs, Gd^Eff, Gd^Eff, Gd, Gd, Gd, Gd, Dd, Dd, Dd^Vda, Rd, Dd^Ftd, Hd^Ftd, Hd^Ftd, Dd^Ftd, Dd^Ftd, Rd, Rd, Dd, Dd
Gd^Fts, Hhd^Fts, Gd^Fts, Gd^Fts, Gd, Hd, Hd, Hd, Hd, Dd^Vdt, Dd, Gd^Gvs, Gd, Gd, Gd, Gd, Gd^Fts, Dd, Dd, Rd, Rd, Dd^Ftd, Dd^Ftd, Dd^Ftd, Rd, Rd, Rd, Rd, Dd, Dd
Gd^Fts, Hhd^Fts, Gd, Gd, Gd, Gd, Hd, Hd, Dd, Dd, Dd, Gd, Gd, Gd^Fts, Gd^Fts, Gd^Fts, Hhd^Fts, Gd^Fts, Dd, Dd, Rd, Dd^Do, Dd^Ftd, Dd^Ftd, Dd^Ftd, Dd^Ftd, Dd, Dd, Dd^Edpp, Dd^Edpp
Gd^Fts, Hhd^Fts, Hhd^Fts, Gd, Gd^Fts, Gd, Dd^Edp, Dd^Edp, Dd^Edp, Dd, Dd, Gd, Gd, Gd^Fts, Hhd^Fts, Hhd^Fts, Hhd^Fts, Gd^Fts, Dd, Dd, Rd, Rd, Dd^Ftd, Hd^Ftd, Hd^Ftd, Dd^Ftd, Dd, Dd, Dd^Edpp, Dd^Edpp
Gd^Fts, Hhd^Fts, Gd^Fts, Gd^Fts, Gd^Fts, Gd^Fts, Gd^Fts, Dd^Edp, Dd^Edp, Dd, Dd, Dd, Dd, Gd^Fts, Gd^Fts, Hhd^Fts, Gd^Fts, Gd^Fts, Dd, Rd, Rd, Rd, Gd^Ftd, Hd^Ftd, Dd^Ftd, Gd^Ftd, Dd, Dd, Dd, Dd^Edpp
Gd^Fts, Gd^Fts, Gd^Fts, Gd^Fts, Gd^Fts, Gd^Fts, Gd^Fts, Dd^Edp, Dd^Edp, Dd^Edp, Hd, Hd, Hd, Dd, Dd, Gd^Fts, Dd, Dd, Rd, Rd, Gd, Gd, Gd, Gd^Ftd, Gd^Ftd, Dd^Ftd, Dd^Ftd, Dd, Dd, Dd
Gd^Fts, Gd^Fts, Hhd, Hhd, Hhd, Gd^Fts, Gd^Fts, Gd^Fts, Gd^Fts, Dd, Dd, Hd, Hd, Hd, Hd, Hd, Hd, Hd, Rd, Dd^Vda, Gd, Gd, Gd, Gd, Gd, Dd^Ftd, Dd^Ftd, Dd, Dd^Edpp, Dd^Edpp
Gd, Gd^Fts, Hhd, Hhd, Hhd, Gd^Fts, Hhd, Gd^Fts, Gd^Fts, Gd^Fts, Gd^Fts, Hd, Gd^Fts, Hd, Hd, Dd^Edp, Dd^Edp, Dd^Edp, Rd, Dd, Gd, Gd, Gd, Gd, Dd^Edpp, Dd, Dd^Edpp, Dd, Dd^Edpp, Dd^Edpp
Gd, Gd, Hhd, Hhd, Hhd, Hhd, Hhd, Hhd, Hhd, Gd^Fts, Gd^Fts, Gd^Fts, Gd^Fts, Dd, Dd, Dd^Edp, Dd^Edp, Rd, Dd, Dd, Dd, Gd, Dd^Edpp, Dd^Edpp, Dd^Edpp, Dd^Edpp, Dd^Edpp, Dd^Edpp, Dd^Edpp, Dd^Edpp
Gd, Gd, Gd, Hhd, Hhd^Ftd, Hhd^Ftd, Hhd^Ftd, Hhd, Hhd, Hhd, Hhd, Gd^Fts, Gd^Fts, Gd^Fts, Gd^Fts, Dd, Dd, Rd, Dd, Dd, Gd, Dd^Edpp, Gd, Dd^Edpp, Gd, Dd^Edpp, Dd^Edpp, Dd^Edpp, Dd^Edpp, Dd^Edpp
Gd, Gd, Gd, Gd, Gd, Hd^Ftd, Hd^Ftd, Hhd^Ftd, Hhd^Ftd, Hhd, Gd^Ftd, Hhd, Gd^Fts, Gd^Fts, Gd^Fts, Dd, Dd, Rd, Dd, Gd, Gd, Gd, Gd, Gd, Gd, Gd, Dd, Dd^Edpp, Dd^Edpp, Dd
Gd, Gd, Gd, Gd, Gd, Hd^Ftd, Hd, Hd^Ftd, Hd^Ftd, Hd^Ftd, Gd^Ftd, Gd^Fts, Gd^Fts, Gd^Fts, Gd^Fts, Dd, Rd, Rd, Dd, Gd, Gd, Gd, Hhd, Gd, Hhd, Gd, Gd, Dd, Dd, Dd
Gd, Gd, Gd, Gd, Gd, Hd, Hd, Hd, Hd, Hd^Ftd, Gd^Ftd, Gd^Ftd, Gd^Ftd, Gd^Fts, Rd, Rd, Rd, Dd, Dd, Gd, Gd, Gd, Md, Md, Md, Hhd, Gd, Dd, Dd, Dd
Gd, Gd, Gd, Gd, Gd, Dd, Dd, Dd^Edp, Hd, Hd^Ftd, Gd^Ftd, Gd^Ftd, Dd^Ftd, Dd^Ftd, Rd, Rd, Dd^Ftd, Dd^Ftd, Dd^Ftd, Dd^Ftd, Dd, Gd, Hhd, Md, Md, Hhd, Gd, Dd, Dd, Dd
Gd, Gd, Gd, Gd, Gd, Dd, Dd, Dd^Edp, Dd^Edp, Dd^Edp, Gd, Gd^Ftd, Dd^Ftd, Rd, Dd^Ftd, Dd^Ftd, Ww, Ww, Ww, Dd^Ftd, Gd, Gd, Gd, Hhd, Gd, Gd, Gd, Dd, Dd, Dd
Gd, Gd, Gd, Gd, Gd, Dd, Dd, Dd, Dd, Dd, Cd, Cd, 2 Kd, Rd, Dd^Ftd, Ww, Ww, Ww, Ww, Gd^Ftd, Gd, Gd, 1 Kd, Gd, Gd, Gd, Gd, Dd, Dd, Dd
Gd, Gd, Gd, Gd, Gd, Gd, Dd, Dd, Dd, Dd, Cd, Cd, Rd, Rd, Dd^Vda, Ww, Ww, Ww, Ww, Gd^Ftd, Gd^Ftd, Cd, Dd, Cd, Gd, Gd, Gd, Dd, Dd, Dd
Gd^Ftd, Gd^Ftd, Gd, Gd, Gd, Gd, Cd, Dd, Dd, Dd, Dd, Cd, Rd, Dd^Ftd, Dd^Ftd, Ww, Ww, Ww, Ww, Ww, Gd^Ftd, Cd, Rd, Cd, Gd, Gd, Dd^Vda, Dd, Dd, Dd
Gd^Ftd, Gd^Ftd, Gd^Ftd, Gd, Cd, Cd, Dd, Dd, Dd^Vda, Dd, Dd, Dd, Rd, Dd^Ftd, Dd^Ftd, Dd^Do, Gd^Ftd, Gd^Ftd, Ww, Gd^Ftd, Gd^Ftd, Gd, Rd, Gd, Gd, Gd, Dd, Dd, Dd, Dd
Gd^Ftd, Gd^Ftd, Gd^Ftd, Gd, Dd, Dd, Dd, Dd, Dd, Dd, Dd, Dd, Dd, Rd, Rd, Dd^Ftd, Dd^Vda, Dd, Rd, Dd^Vda, Rd, Rd, Dd, Dd, Dd, Dd, Dd, Dd, Dd, Dd
Gd^Ftd, Gd^Ftd, Gd^Ftd, Dd^Ftd, Dd^Ftd, Dd, Dd, Dd, Dd, Dd, Dd, Dd, Dd, Dd, Dd, Rd, Rd, Rd, Dd, Rd, Dd, Dd, Dd, Dd, Dd, Dd, Dd, Dd, Dd, Dd
Gd^Ftd, Gd^Ftd, Dd^Ftd, Dd^Ftd, Dd^Ftd, Dd^Ftd, Dd, Dd, Dd, Dd, Dd, Dd, Dd, Dd, Dd, Dd, Rd, Dd, Dd, Dd, Dd, Dd, Dd, Dd, Dd, Dd, Dd, Dd, Dd, Dd
