Ss, Ss, Ss, Ss, Ss, Gg, Gg, Gs^Fms, Gs^Fms, Gs^Fms, Gs^Fms, Gs^Fms, Wwf, Wwf, Wwf, Gg^Efm, Gs^Fms, Gs^Fms, Gs^Fms, Gg, Gg, Gg, Gg
Ss, Ss, Ss, Ss, Ss^Ftr, Ss^Ftr, Gg, Gd, Gd, Gs^Fms, Gd, Gs^Fms, Wwf, Wwf, Gd, Gg^Efm, Ce, Gs^Fms, Ce, Gg, Gg, Gg^Ve, Gs^Fms
Ss, Ss, Ss, Ss^Ftr, Ss^Ftr, Ss, Gg, Gd, Wwf, Gd, Ww, Ww, Gd, Gd, Gd, Gd, Gd, Ce, 1 Ke, Ce, Gs^Fms, Gs^Fms, Mm
Ss, Ss, Ss, Ss, Ss, Ss^Ftr, Ww, Ww, Ww, Wwf, Hh^Fms, Gd, Gd, Gd, Gd, Gd, Gd, Gd, Ce, Gs^Fms, Mm, Mm, Mm
Ss, Ss, Ss, Ss, Ww, Ww, Ss, Ww, Ss, Ww, Gg, Gd^Vh, Hh^Fms, Gd, Gd, Gd, Gd, Gd, Hh^Fms, Hh^Fms, Mm, Mm, Mm
Ss, Ss, Ss, Ww^Vm, Ww, Ss, Ss, Ss, Ss^Ftr, Ss, Ss, Gs^Fms, Gs^Fms, Hh^Fms, Gd, Gd, Gd, Gd, Hh^Fms, Mm, Mm, Mm, Mm
Ss, Ss, Ss, Ww, Ww, Ww, Ss^Ftr, Ss^Ftr, Ss^Ftr, Ss^Ftr, Ss^Ftr, Ss, Ss, Gs^Fms, Gs^Fms, Gd, Gd, Gd, Hh, Mm, Mm, Mm, Mm
Ss, Ss, Ss, Ww, Ww, Ww, Ww, Ss^Ftr, Ww, Ss^Ftr, Ww, Wwf, Wwf, Ss, Gg, Gd, Gd, Gd, Gd^Fms, Hh, Hh, Mm, Mm
Ss, Ss, Ss, Ss, Ww, Ww, Ww, Ss, Ww, Ww, Ww, Ww, Wwf, Ss, Gg, Gd, Gd, Gd, Gd^Fms, Hh^Fms, Mm, Mm, Mm
Ss, Ss, Ss, Ss, Ss, Ww, Ss, Ss, Ss, Ww, Ww, Ss^Ftr, Ss^Ftr, Ss^Ftr, Gs^Fms, Gs^Fms, Gd, Gd^Fms, Hh^Fms, Hh^Fms, Mm, Mm, Mm
Ss, Ss, Ss, Ss, Ss, Ss, Ss, Ss, Ss, Ss^Vhs, Wwf, Wwf, Ss^Ftr, Gs^Fms, Gs^Fms, Gs^Fms, Gd, Gd^Fms, Mm^Vhh, Mm, Mm, Mm, Mm
Ss, Ss, Ss, Ss, Ss, Ss^Ftr, Dd, Ss, Dd, Sm, Sm, Sm, Gg, Gg, Gd, Gd, Gd, Gd, Mm, Mm, Mm, Mm, Mm
Ss, Ss, Ww, Ww, Ww, Ss^Ftr, Ss, Dd^Edp, Dd, Dd, Dd^Edp, Gd, Gd, Gd, Dd, Gd, Dd, Gd, Hhd, Mm, Mm, Mm, Mm
Ss, Ww, Ww, Ss^Ftr, Ss^Ftr, Ss^Ftr, Ss, Dd^Edpp, Dd^Ftd, Dd^Vdr, Dd^Ftd, Dd, Dd, Dd, Dd, Dd, Dd, Dd, Dd, Hhd, Mm, Mm, Mm
Ss, Ww, Ss, Ww, Ss^Ftr, Ss, Dd^Ftd, Dd^Ftd, Dd^Ftd, Dd^Ftd, Dd^Dc, Dd, Dd^Edpp, Dd, Dd^Edp, Dd, Dd, Dd, Dd, Hhd, Mm, Mm, Mm
Ss, Ss, Chs, Chs, 2 Khs, Dd^Ftd, Dd^Ftd, Dd^Ftd, Dd^Ftd, Dd^Do, Dd^Ftd, Dd, Dd, Dd, Dd, Dd, Dd^Edpp, Dd, Hhd, Hhd, Mm, Mm, Mm
Ss, Ss, Ss^Vhs, Chs, Chs, Sm, Dd^Ftd, Dd^Ftd, Dd^Ftd, Dd^Ftd, Dd, Dd, Dd, Dd, Dd, Dd, Dd, Dd^Edp, Dd^Ftd, Hhd, Hhd, Mm, Mm
Ss, Ss, Ss, Ss, Sm, Ss, Ss, Dd^Ftd, Dd^Ftd, Dd, Dd, Dd, Dd^Edpp, Dd, Dd, Dd^Edp, Dd^Edpp, Dd^Vdr, Wwf, Dd^Ftd, Dd^Ftd, Hhd, Hhd
Ss, Ss, Ss, Ss, Sm, Ss, Sm, Ss, Dd^Ftd, Dd^Ftd, Dd^Ftd, Dd, Dd, Dd, Dd, Dd, Dd, Dd^Ftd, Wwf, Wwf, Dd^Ftd, Dd, Dd
Ss, Ss, Ww, Ww, Ww, Sm, Ss, Sm, Ss, Dd^Ftd, Dd^Ftd, Dd, Dd, Dd, Dd, Dd, Dd, Dd^Ftd, Dd^Ftd, Dd^Ftd, Dd^Ftd, Dd, Dd
Ss, Ss, Ww, Ss, Ss, Ww, Ss, Ss, Ss, Ss, Dd^Ftd, Dd^Ftd, Dd, Dd, Dd, Dd, Hd, Dd^Ftd, Hd, Dd^Ftd, Hd, Dd^Edpp, Dd^Edp
Ss, Ss, Ss, Ww, Ww, Ww, Ss, Ss, Sm, Ss, Dd^Ftd, Dd^Ftd, Dd, Dd, Dd^Edpp, Dd^Edpp, Hd, Hd, Mdd, Hd, Hd, Hd, Hd
Ss^Ftr, Ss^Ftr, Ss^Ftr, Ww, Ww, Ss, Ss, Ss, Sm, Sm, Dd^Ftd, Dd^Ftd, Dd, Dd^Edpp, Dd, Hd, Hd, Mdd, Mdd, Mdd, Mdd, Mdd, Mdd
Ss^Ftr, Ss^Ftr, Ww, Ww, Ss, Ss, Ss, Ss, Sm, Ss, Dd, Dd, Dd, Dd^Edpp, Hd^Vdr, Hd, Mdd, Mdd, Mdd, Mdd, Mdd, Mdd, Mdd
Ss^Ftr, Ss^Ftr, Ss^Ftr, Ss^Ftr, Ss^Ftr, Ss, Wwf, Sm, Dd^Vdr, Dd, Dd^Edpp, Dd, Dd, Dd^Edpp, Hd, Mdd, Mdd, Mdd, Mdd, Mdd, Mdd, Mdd, Dd
Ss^Ftr, Ss^Ftr, Ww, Ww^Vm, Ss^Ftr, Wwf, Dd^Ftd, Dd^Ftd, Dd^Ftd, Dd, Dd, Dd, Dd, Dd, Cdr, Mdd, Mdd, Mdd, Mdd, Mdd, Mdd, Hd, Dd
Ss^Ftr, Ww, Ww, Ss^Ftr, Ss, Wwf, Dd^Ftd, Dd^Ftd, Dd, Dd, Dd, Dd, Dd^Edp, Dd, Cdr, 3 Kdr, Cdr, Mdd, Mdd, Mdd, Hd, Hd, Dd
Ss^Ftr, Ww, Ww, Ss, Sm, Dd^Ftd, Dd^Ftd, Dd^Ftd, Dd^Edpp, Dd, Dd, Dd, Dd, Dd, Dd, Cdr, Hd, Hd, Hd, Hd, Dd^Do, Dd^Ftd, Dd
Ww, Ww, Ss, Ss, Sm, Dd^Ftd, Dd^Ftd, Dd^Ftd, Dd, Dd, Dd, Dd, Dd^Edpp, Dd, Dd, Dd, Dd, Dd, Dd, Dd^Ftd, Dd^Ftd, Dd^Ftd, Dd
Ss, Ss, Sm, Sm, Dd, Dd^Ftd, Dd, Dd, Dd, Dd, Dd, Dd, Dd^Edp, Dd^Edp, Dd, Dd, Dd, Dd, Dd, Dd, Dd, Dd^Edp, Dd
