Gs^Fms, Gs^Fms, Gs^Fms, Gs^Fms, Gs^Fms, Gs^Fms, Gs^Fms, Gs^Fms, Gs^Fms, Gs^Fms, Hh^Fms, Hh^Fms, Hh^Fms, Mm, Mm, Mm, Mm, Mm, Mm, Mm, Mm, Mm, Mm, Gg, Hh^Fms, Gs^Fms, Gs^Fms, Gs^Fms, Gs^Fms, Re, Gg, Gg, Gg, Gg, Gg, Gg, Gg, Gg, Gg, Gg, Gg, Gg, Gg, Gg, Gg, Ss, Ww, Ww, Ww, Ww
Gs^Fms, Gs^Fms, Gs^Fms, Gs^Fms, Gs^Fms, Gs^Fms, Gs^Fms, Gs^Fms, Gs^Fms, Gs^Fms, Hh^Fms, Hh^Fms, Hh^Fms, Hh^Fms, Mm, Mm, Mm, Mm, Mm, Mm, Mm, Mm, Mm, Hh, Hh^Fms, Hh^Fms, Gs^Fms, Gs^Fms, Gs^Fms, Re, Gg, Gg, Gg, Gg, Gg, Gg, Hh^Fms, Hh^Vo, Hh^Fms, Gg, Gg, Gg, Hh^Fms, Gg, Gg, Ss, Ss, Ss, Ww, Ww
Gs^Fms, Gs^Fms, Gs^Fms, Gs^Fms, Gs^Fms, Gs^Fms, Gs^Fms, Gs^Fms, Gs^Fms, Gs^Fms, Hh^Fms, Hh^Fms, Wo, Wo, Wo, Mm, Wo, Wo, Wo, Mm, Mm, Mm, Mm, Hh, Hh^Fms, Hh^Fms, Gs^Fms, Gs^Fms, Gs^Fms, Re, Gg, Gg, Gg, Gg, Hh^Fms, Hh^Fms, Hh^Fms, Hh^Fms, Hh^Fms, Hh^Fms, Hh^Fms, Hh^Fms, Co, Hh^Fms, Co, Gg, Ss, Ww, Ss, Ww
Gs^Fms, Gs^Fms, Gs^Fms, Gs^Fms, Gs^Fms, Gs^Fms, Hh^Fms, Gs^Fms, Gs^Fms, Hh^Fms, Wwt, Wwt, Wo, Wo, Wo, Wo, Wo, Wo, Wo, Mm, Mm, Mm, Hh^Fms, Hh^Fms, Hh^Fms, Hh^Fms, Gs^Fms, Gs^Fms, Gg, Re, Gg, Gg, Gg, Hh^Fms, Mm, Hh^Fms, Hh^Fms, Hh^Fms, Mm, Hh^Fms, Mm, Co, 5 Ko, Co, Hh^Fms, Gg, Gg, Ss, Ss, Ww
Gs^Fms, Gs^Fms, Gs^Fms, Gs^Fms, Gs^Fms, Gs^Fms, Hh^Fms, Hh^Fms, Gs^Fms, Hh^Fms, Wwt, Wo, Wo, Wo, Wo, Wo^Vm, Wo, Wo, Wo, Mm, Mm, Mm, Hh^Fms, Hh^Fms, Hh^Fms, Hh^Fms, Gs^Fms, Gs^Fms, Re, Re, Hh^Fms, Gg, Hh^Fms, Hh^Fms, Mm, Hh^Fms, Hh^Fms, Hh^Fms, Mm, Mm, Mm, Mm, Mm, Mm, Mm, Hh^Fms, Gg, Gg, Gg, Ss
Gs^Fms, Gs^Fms, Hh^Fms, Gs^Fms, Hh^Fms, Hh^Fms, Hh^Vo, Hh^Fms, Hh^Fms, Hh^Fms, Wwt, Wo, Wo, Wo, Wo, Wo, Wo, Wo, Mm, Mm, Mm, Hh, Hh^Fms, Hh^Fms, Hh^Fms, Gs^Fms, Gs^Fms, Gs^Vo, Re, Hh^Fds, Hh^Fms, Hh^Fms, Hh^Fms, Mm, Mm, Mm, Mm, Mm, Mm, Mm, Ww, Mm, Mm, Mm, Mm, Hh^Fms, Gg, Gg, Gg, Gg
Hh^Fms, Hh^Fms, Hh^Fms, Hh^Fms, Hh^Fms, Hh^Fms, Hh^Fms, Hh^Fms, Hh^Fms, Hh^Fms, Wwt, Wo, Wo, Wo, Wo, Mm, Mm, Mm, Mm, Mm, Hh, Hh, Hh, Hh^Fms, Gs^Fms, Gs^Fms, Gg, Gg, Re, Hh^Fms, Hh^Fms, Hh^Fms, Mm, Mm, Mm, Mm, Mm, Mm, Mm, Ww, Ww, Ww, Mm, Mm, Mm, Hh^Fms, Gg, Gg, Gg, Gg
Hh^Fms, Hh^Fms, Hh^Fms, Hh^Fms, Hh^Fms, Hh^Fms, Hh^Fms, Hh^Fms, Hh^Fms, Hh^Fms, Wwt, Wwt, Wwt, Wo, Co, Mm, Mm, Mm, Mm^Vo, Mm, Hh, Hh, Hh, Hh, Gg, Gg, Gg, Re, Gg, Hh^Fms, Hh^Fds, Hh^Fms, Mm, Mm, Mm, Mm, Mm, Mm, Mm, Ww, Ww, Ww, Mm, Mm, Mm, Hh^Fms, Gg, Gg, Gg, Gg
Gg^Fds, Hh^Fms, Gg^Fds, Hh^Fms, Hh^Fms, Hh^Fms, Gg^Fds, Gg^Fds, Hh^Fms, Hh^Fms, Wwt, Wwt, Hh^Vo, Co, 2 Ko, Co, Mm, Mm, Mm, Mm, Hh, Hh, Hh, Hh, Gg, Gg, Gg, Re, Gg^Fds, Hh^Fds, Hh^Fds, Hh^Fds, Hh^Fds, Mm, Mm, Mm, Co, Co, Co, Mm, Ww, Ww, Mm, Mm, Hh^Fms, Hh^Fms, Gg, Gg, Gg, Gg
Gg^Fds, Gg^Fds, Gg^Fds, Gg^Fds, Gg^Fds, Gg^Fds, Gg^Fds, Gg^Fds, Wwt, Wwt, Wwt, Wwt, Hh, Co, Co, Co, Mm, Mm, Mm, Mm, Mm, Hh, Hh, Hh, Hh^Fds, Gg, Gg, Re, Re, Hh^Fds, Hh^Fds, Hh^Fds, Hh^Fds, Mm, Mm, Mm, Co, 3 Ko, Co, Mm, Ww, Ww, Mm, Mm, Hh^Fms, Hh^Fms, Gg, Gg, Gg, Gg
Gg^Fds, Gg^Fds, Gg^Fds, Gg^Fds, Gg^Fds, Gg^Fds, Gg^Fds, Gg^Fds, Wwt, Wwt, Wwt, Wwt, Hh, Hh, Hh, Hh, Mm, Mm, Mm, Mm, Mm, Hh, Hh^Fds, Hh^Fds, Hh^Fds, Gg^Fds, Gg, Gg, Gg, Re, Re, Hh^Fds, Hh^Fds, Hh^Vo, Hh, Mm, Re, Co, Mm, Mm, Ww, Ww, Mm, Mm, Hh, Hh^Fms, Hh^Vo, Gg, Gg, Gg
Gg^Fds, Gg^Fds, Gg^Fds, Gg^Fds, Gg^Fds, Gg^Fds, Gg^Fds, Gg^Fds, Wwt, Wwt, Wwt, Wwt, Hh, Hh, Wwf, Hh, Mm, Mm, Mm, Mm, Hh^Fds, Hh^Fds, Hh^Fds, Hh^Fds, Hh^Fds, Gg^Fds, Gs^Vl, Gg, Gg, Gg, Gg, Re, Re, Re, Re, Hh, Re, Re, Ww, Ww, Ww, Ww, Hh, Hh, Hh^Fms, Hh^Fms, Hh^Fms, Gg, Gg, Gg
Gg^Fds, Gg^Fds, Gg^Fds, Gg^Fds, Gg, Gg, Gg, Hh, Wwt, Wwt, Wwt, Wwt, Wwf, Wwf, Wwf, Wwf, Mm, Mm, Mm, Mm, Hh^Fds, Hh^Fds, Hh^Fds, Hh^Fds, Gg^Fds, Gg^Fds, Gg^Fds, Gg, Gg, Gg, Gg, Gg, Gg, Gg, Gg, Re, Re, Hh, Ww, Ww, Ww, Hh^Fms, Hh^Fms, Hh^Fms, Hh^Fms, Hh^Fms, Gg, Gg, Gg, Gg
Gg^Fds, Gg^Fds, Gg^Fds, Gg^Fds, Gg^Fds, Gg, Gg, Hh, Hh, Wwt, Wwt, Wwt, Wwf, Wwf, Hh, Hh, Hh^Vo, Mm, Mm, Mm, Mm, Hh^Fds, Hh^Fds, Hh^Fds, Hh^Fds, Gg^Fds, Gg^Fds, Gg, Gg, Gg, Gg, Gg, Gg, Gg, Gg, Re, Hh, Hh, Hh^Vo, Ww, Ww, Hh^Fms, Hh^Fms, Hh^Fms, Gg^Fds, Gg, Gg, Gg, Gg, Gg
Gg^Fds, Gg^Fds, Gg^Fds, Gg^Fds, Gg^Fds, Gg, Hh, Hh^Vo, Hh, Wwt, Wwt, Wwf, Wwf, Hh, Hh, Hh, Hh, Mm, Mm, Mm, Mm, Mm, Hh^Fds, Hh^Fds, Hh^Fds, Gg^Fds, Gg, Gg, Gg, Gg, Gg, Gg, Gg, Gg, Gg, Re, Gg, Ds, Ww, Ww, Gg^Fds, Gg^Fds, Gg^Fds, Gg^Fds, Gg, Gg, Gg, Gg, Gg, Gg
Gg^Fds, Gg^Fds, Gg^Fds, Gg^Fds, Hh^Fds, Hh^Fds, Hh^Fds, Hh, Wwf, Wwt, Wwf, Wwf, Gg, Re, Re, Hh, Hh, Hh, Hh^Fds, Mm, Mm, Mm, Hh^Fds, Hh^Fds, Hh^Fds, Gg^Fds, Gg, Gg, Gg, Gg, Gg, Gg, Gg, Gg, Re, Re, Gg, Ds, Ww, Ww, Ds, Gg^Fds, Gg, Gg, Gg, Gg, Gg, Gg, Gg, Gg
Gg^Fds, Gg^Fds, Gg^Fds, Gg^Fds, Hh^Fds, Hh^Fds, Hh^Fds, Hh, Wwf, Wwf, Wwt, Wwt, Gg, Gg, Re, Hh, Hh^Fds, Hh^Fds, Hh^Fds, Hh^Fds, Hh^Fds, Hh, Hh, Hh^Fds, Hh, Gg, Gg, Gg, Gg, Gg, Gg, Gg, Re, Re, Gg, Gg, Gg, Ds, Wwf, Ww, Ds, Gg, Gg^Fds, Gg, Gg, Gg, Gg, Gg, Gg, Gg
Gg^Fds, Gg^Fds, Gg^Fds, Hh^Fds, Hh^Fds, Hh^Fds, Hh^Fds, Wwt, Wwt, Wwt, Wwt, Wwt, Gg, Gg, Re, Gg, Gg^Fds, Hh^Fds, Hh^Fds, Hh^Fds, Hh^Fds, Hh, Hh, Hh, Hh, Gg, Gg, Gg, Gg, Gg, Gd^Vo, Re, Gg, Gg, Gg, Gg, Gg, Ds, Ds, Ww, Gg^Fds, Gg^Fds, Hh^Fds, Hh^Fds, Hh, Gg, Gg, Gg, Gg, Gg
Gg^Fds, Gg^Fds, Gg^Fds, Gg^Fds, Hh^Fds, Hh^Fds, Hh, Wwt, Wwt, Wwt, Gg, Gg, Gg, Gg, Gg, Re, Re, Gg^Fds, Hh^Fds, Hh^Fds, Hh^Fds, Hh^Fds, Hh, Hh, Gg, Gg, Gg, Gg, Gg, Gg, Re, Re, Gg, Gg, Gg, Gg, Gg, Ds, Ds, Wwf, Hh^Fds, Hh^Fds, Hh^Fds, Hh^Fds, Hh, Gg, Gg, Gg, Gg, Gg
Gg^Fds, Gg^Fds, Gg^Fds, Gg^Fds, Gg^Fds, Hh^Fds, Hh, Hh, Wwt, Wwt, Wwt, Gg, Gg, Gg, Gg, Gg, Gg, Re, Rb^Gvs, Hh^Fds, Gg^Fds, Gg^Fds, Rb^Gvs, Rb^Gvs, Gg, Gg, Gg, Gg, Re, Re, Gg, Gg, Gg, Gg, Gg, Gg, Gg, Ds, Wwf, Wwf, Wwf, Hh^Fds, Gg, Hh^Vhh, Gg, Gg, Gg, Gg, Hh, Hh
Gg^Efm, Gg^Fds, Gg^Fds, Gg^Fds, Gg^Fds, Hh^Fds, Wwt, Wwt, Wwt, Wwt, Wwt, Gg, Gg, Gg, Gg, Gg, Gg, Re, Rb^Gvs, Rb^Gvs, Rb^Gvs, Rb^Gvs, Rb^Gvs, Rb^Gvs, Gg, Gg, Gg, Gg, Re, Gg, Gg, Gg, Gg, Gg, Gg, Gg, Gg, Wwf, Wwf, Hh^Fds, Hh, Wwf, Gg, Gg, Gg, Gg, Gg, Hh, Hh, Hh
Gg^Efm, Gg^Efm, Gg^Efm, Gg^Fds, Gg^Efm, Gg^Efm, Gg^Efm, Wwt, Wwt, Wwt, Wwf, Gg, Gg, Gg, Gg, Gg, Gg, Re, Rb^Gvs, Rb^Gvs, Rb^Gvs, Rb^Gvs, Rb^Gvs, Rb^Gvs, Gg, Gg, Gg, Gg, Re, Gg, Gg, Gg, Gg, Gg, Gg, Gg, Gg, Wwf, Wwf, Hh^Fds, Wwf, Wwf, Gg, Gg, Gg, Gg, Co, Co, Co, Hh
Gg^Efm, Gg^Efm, Gg^Efm, Gg^Efm, Gg, Gg^Efm, Gg^Efm, Wwt, Wwt, Wwt, Wwf, Gg, Gg, Gg, Gg, Gg, Gg, Re, Re, Rb^Gvs, Rb^Gvs, Rb^Gvs, Rb^Gvs, Rb^Gvs, Gg, Gg, Gg, Gg, Re, Gg, Gg, Gg, Gg, Gg, Gg, Gg, Ds, Ds, Wwf, Wwf, Wwf, Wwf, Ds, Gg, Gg, Gg, Co, 4 Ko, Co, Hh
Gs^Fds, Gg^Efm, Gg^Efm, Gg^Efm, Gg^Efm, Gg^Efm, Gg^Efm, Gs^Vc, Wwt, Wwt, Wwt, Wwf, Wwf, Gg, Gg, Gg, Gg, Gg, Gg, Re, Re, Gg^Vwm, Rb^Gvs, Rb^Gvs, Gg, Gg, Re, Gg, Re, Gg, Gg, Gg, Gg, Gg, Gg, Gg, Ds, Wwf, Wwf, Wwf, Wwf, Ds, Ds, Gg, Gg, Gg, Gg, Co, Hh, Hh
Gs^Fds, Gs^Fds, Gs^Fds, Gg^Efm, Gs^Fds, Gs^Fds, Gs^Fds, Gs^Fds, Gs^Fds, Wwt, Wwt, Wwt, Wwf, Gg, Gg, Gg, Gg, Gg, Gg, Gg, Gg, Re, Re, Chr, Re, Re, Gg, Re, Gg, Gg, Gg, Gg, Gg, Gg, Gg, Gg, Gg, Ds, Wwf, Ds, Ds, Ds, Gg, Gg, Gg, Gg, Gg, Hh, Hh, Hh
Gg, Gg, Gg, Gs^Fds, Gg, Gs^Fds, Gs^Fds, Gs^Fds, Wwt, Wwt, Wwt, Wwt, Gg, Gg, Gg, Gg, Gg, Gg, Gg, Gg, Gg, Hh^Fds, Hh^Fds, Re, Chr, Gg, Gg, Gg, Gg, Gg, Gg, Gg, Gg, Gg, Gg, Gg, Gg, Gd^Vo, Wwf, Gg, Gg, Gg, Gg, Gg, Gg, Gg, Gg, Hh, Hh, Hh
Gg, Gg, Gg, Gg, Gg, Gg, Wwf, Wwt, Wwt, Wwt, Wwt, Wwt, Gg, Gg, Gg, Gg, Gg, Gg, Gg, Gg, Gg, Gs^Fds, Hh^Fds, Re, Hh^Fds, Gg^Vo, Gg, Gg, Gg, Gg, Gg, Gg, Gg, Gg, Gg, Gg, Gg, Wwf, Gg, Gg, Gg, Gg, Re, Re, Re, Gg, Re, Gg, Re, Re
Gg^Fds, Gg^Fds, Gg^Fds, Gg, Gs^Fds, Gg, Wwf, Wwt, Wwt, Wwt, Wwt, Gg, Gg, Gg, Gg, Gg, Gg, Gg, Gg, Gg, Gg, Gg, Chr, Re, Hh^Fds, Gs^Fds, Gs^Fds, Gg, Gg, Gg, Gg, Gg, Gg, Gg, Gg, Gg, Wwf, Wwf, Gg, Gg, Re, Re, Gg, Gg, Gg, Re, Gg^Vo, Re, Gg, Re
Gs^Ftp, Gs^Ftp, Gs^Ftp, Gs^Fds, Gs^Fds, Gs^Fds, Gs^Fds, Gs^Fds, Gs^Fds, Wwt, Wwt, Wwt, Wwt, Gg, Gs^Ftp, Gg, Gg, Gg, Gg, Gg, Gg, Gg, Re, Re, Re, Re, Re, Gg, Gg, Gg, Gg, Gg, Gg, Gg, Gg, Wwf, Wwf, Wwf, Re, Re, Gg, Gg, Gg, Gg, Gg, Gg, Gg, Gg, Gg, Gg
Gs^Ftp, Gs^Ftp, Gs^Ftp, Gs^Ftp, Gs^Fds, Gs^Fds, Gs^Fds, Gs^Fds, Gs^Fds, Gs^Fds, Gs^Fds, Wwt, Wwt, Wwt, Wwf, Gs^Ftp, Gs^Ftp, Gg, Gg, Gg, Re, Re, Gs^Vh, Gs^Fds, Gs^Fds, Hh^Fds, Re, Gg, Gg, Gg, Gg, Gg, Gg, Gg, Gg, Gg, Re, Wwf^Bw/r, Gg, Gg, Gg, Gg, Gg, Gg, Gg, Gg, Gg, Gg, Gg, Gg
Gs^Ftp, Gs^Ftp, Gg^Fds, Gs^Fds, Gs^Ftp, Gs^Ftp, Gs^Fds, Gs^Fds, Gs^Fds, Gs^Fds, Gs^Fds, Ww^Vm, Wwt, Wwt, Wwf, Gs^Ftp, Gg, Gg, Re, Re, Gg, Gg, Gg, Gg, Gg, Gg, Gg, Re, Re, Gg, Gg, Gg, Gg, Gg, Re, Re, Wwf, Wwf, Gg, Gg, Gg, Gg, Hh, Gg, Gg, Gg, Gg, Gg, Gg, Gg
Gg^Fds, Gg^Fds, Gg^Fds, Gs^Fds, Gs^Ftp, Gs^Ftp, Gs^Ftp, Gs^Ftp, Wwt, Gs^Fds, Wwt, Wwt, Wwf, Wwf, Wwf, Wwf, Re, Re, Wwf, Gg, Wwf, Gg, Wwf, Gg, Gg, Gg, Gg, Gg, Gg, Re, Re, Re, Re, Re, Gg, Gg, Wwf, Wwf, Gg, Gg, Hh^Fds, Hh, Mm, Hh, Mm, Gg, Gg, Gg, Gg, Gg
Gg^Fds, Gg^Fds, Gg^Fds, Gg^Fds, Wwt, Gs^Ftp, Wwt, Wwt, Wwt, Wwf, Wwf, Wwf, Dd^Ftd, Wwf, Dd^Ftd, Wwf, Wwf^Bw|r, Wwf, Sm, Wwf, Sm^Ftr, Wwf, Sm, Ww, Ww, Gg, Sm, Gg, Gg, Gg, Gg, Gg, Gg, Gg, Gg, Gg, Wwf, Wwf, Wwf, Hh^Fds, Hh^Fds, Mm, Ww, Mm, Ww, Mm, Ss^Vhs, Gg, Gg, Gg
Gg^Fds, Gg^Fds, Wwt, Wwt, Wwt, Wwt, Wwf, Wwt, Wwf, Wwf, Dd^Ftd, Dd^Ftd, Dd^Ftd, Dd^Ftd, Dd, Dd, Rd, Dd, Dd^Ftd, Sm^Ftr, Ss^Ftr, Sm^Ftr, Ss, Ww, Ss^Ftr, Ww, Ww, Sm, Sm, Gg, Gg, Gg, Gg, Gg, Gg, Gd^Vo, Wwf, Wwf, Ss, Ss, Ss, Ss, Ww, Ww, Ww, Mm, Ss, Gg, Gg, Gg
Gg^Fds, Gg^Fds, Wwt, Wwt, Wwf, Wwf, Dd^Ftd, Wwf, Wwf, Dd, Dd, Dd, Dd, Dd, Rd, Rd, Rd, Dd^Edpp, Dd, Dd, Dd^Edp, Ss, Dd, Dd, Sm, Ss^Ftr, Ss^Ftr, Ss^Ftr, Ss, Sm, Sm, Gg, Gg, Gg, Gg, Wwf, Hh^Fds, Mm, Ww, Ss, Ww, Ww, Ww, Ww, Ww, Ww, Mm, Hh, Gg, Gg
Wwt, Wwt, Wwt, Wwt, Wwf, Wwf, Dd^Ftd, Dd^Ftd, Dd^Ftd, Dd, Dd, Dd, Rd, Rd, Dd^Ftd, Dd^Edp, Dd, Dd^Vda, Dd^Do, Dd, Dd^Edpp, Dd, Dd^Edp, Dd, Dd, Sm^Ftr, Sm^Ftr, Sm^Ftr, Sm, Ss, Wwf, Gg, Gg, Gg, Gg, Wwf, Hh, Mm, Ww, Ww, Ww, Ww, Ww, Ww, Ww, Ww, Ss, Hh, Hh, Hh^Fds
Wwf, Wwt, Wwf, Wwt, Wwf, Dd^Ftd, Dd^Ftd, Dd^Ftd, Dd^Ftd, Dd, Rd, Rd, Rd, Dd^Ftd, Dd^Ftd, Dd^Ftd, Dd^Ftd, Dd, Dd, Dd^Edp, Dd, Dd, Dd^Edpp, Dd^Edpp, Dd, Dd, Dd, Dd^Ftd, Dd, Ss, Ss, Wwf, Gg, Gg, Wwf, Wwf, Ss, Ss, Ss, Ww, Ss, Ww, Ww, Ww, Ss, Ww, Mm, Hh, Hh^Fds, Hh^Fds
Dd^Ftd, Wwf, Dd^Ftd, Wwf, Dd^Ftd, Dd^Ftd, Dd^Ftd, Dd^Ftd, Ce, Ce, Ce, Rd, Rd, Dd^Ftd, Dd^Ftd, Dd^Ftd, Dd^Ftd, Dd^Ftd, Dd^Ftd, Dd, Dd^Ftd, Dd^Ftd, Dd^Ftd, Dd^Ftd, Dd^Ftd, Dd^Ftd, Dd^Edp, Dd, Dd, Dd, Ss, Ww, Sm^Ftr, Wwf, Ss^Vhs, Wwf, Ss, Ss, Ww, Ww, Mm, Ss, Mm, Ss, Mm, Ss, Ss, Hh^Fds, Hh^Fds, Hh^Fds
Dd^Ftd, Dd^Ftd, Dd^Ftd, Dd^Ftd, Dd^Ftd, Dd^Ftd, Dd^Ftd, Dd, Ce, 1 Ke, Ce, Re^Vct, Rd, Dd^Ftd, Dd^Ftd, Dd^Ftd, Dd^Ftd, Dd^Ftd, Dd^Ftd, Dd^Ftd, Dd^Ftd, Dd^Ftd, Dd^Ftd, Dd^Ftd, Dd^Ftd, Dd^Ftd, Dd^Ftd, Dd^Edp, Dd^Ftd, Dd, Sm, Ss, Ss^Ftr, Wwf, Ss, Ss, Ss, Ww, Ww, Ss, Hh^Fds, Hh^Fds, Gg, Hh, Gg, Ss, Gg, Gg, Gg, Hh^Fds
Dd^Ftd, Dd^Ftd, Dd^Ftd, Dd^Ftd, Dd^Ftd, Dd^Ftd, Dd^Edp, Dd, Dd^Edp, Rd, Rd, Rd, Dd, Dd^Ftd, Dd^Ftd, Dd^Ftd, Dd^Ftd, Dd^Ftd, Dd^Ftd, Dd^Ftd, Dd^Ftd, Dd^Ftd, Dd^Ftd, Dd^Ftd, Dd^Ftd, Dd, Dd, Dd, Dd, Sm, Sm, Ss, Sm^Ftr, Ss^Ftr, Ss^Ftr, Ss, Ss, Ww, Ss, Ss, Gg, Gg, Gg, Gg, Gg, Gg, Gg, Gg, Gg, Gg
Dd^Ftd, Dd^Ftd, Dd^Ftd, Dd^Ftd, Dd^Ftd, Dd^Ftd, Dd, Dd, Dd^Edp, Rd, Dd, Dd, Dd, Dd, Dd^Edpp, Dd, Dd^Edpp, Dd^Ftd, Dd^Ftd, Dd^Ftd, Dd^Ftd, Dd^Ftd, Dd^Ftd, Dd, Dd, Dd^Edpp, Dd, Dd, Dd, Dd, Dd, Dd, Dd^Edpp, Ss, Ww, Ww, Ww^Ftr, Ss, Ss, Gg, Gg, Gg, Gg, Gg, Gg, Gg, Gg, Gg, Gg, Gg
Dd^Ftd, Dd^Ftd, Dd^Ftd, Dd^Ftd, Gg, Dd^Ftd, Rd, Rd, Rd, Rd, Rd, Rd, Dd, Dd^Edp, Dd, Dd^Edpp, Dd, Dd^Ftd, Dd^Ftd, Dd^Ftd, Dd^Ftd, Dd^Edp, Dd, Dd^Ftd, Dd, Dd, Dd, Dd, Dd, Dd, Dd^Edpp, Dd, Dd, Ss, Ss, Ww^Ftr, Ww^Ftr, Ww^Ftr, Ss, Gg, Gg, Gg, Gg, Gg, Gg, Gg, Gg, Gg, Gg, Gg
