Dd, Dd, Dd, Dd, Dd, Dd, Dd^Edp, Dd^Edpp, Dd, Dd^Edp, Dd, Dd, Dd, Dd, Mdd, Mdd, Mdd, Mdd, Mdd^Xm, Mdd^Xm, Mdd^Xm, Mdd^Xm, Mdd^Xm, Mdd^Xm, Mdd^Xm, Mdd^Xm, Mdd^Xm, Mdd^Xm, Mdd^Xm, Mdd, Mdd, Mdd, Mdd, Mdd, Mdd, Hd, Hd, Hd, Rd, Rd, Rd^Br/, Rd^Br/, Dd, Dd, Dd, Dd, Dd^Edpp, Dd^Edp, Dd, Dd^Edpp, Rd, Rd, Dd^Ftd, Dd^Ftd, Dd^Edp, Dd, Dd, Dd, Dd, Dd^Edp, Dd, Dd, Dd, Dd, Dd^Ftd, Dd, Dd^Ftd, Dd^Edp, Dd, Dd, Rd, Dd^Edp, Dd, Dd, Dd, Dd^Edp, Dd, Dd, Dd, Dd, Dd, Dd
Dd^Edp, Dd^Ftd, Dd, Dd, Dd, Dd, Dd, Dd, Dd, Dd^Edp, Hd, Dd, Dd^Ftd, Dd, Mdd, Mdd, Mdd, Mdd, Mdd^Xm, Mdd^Xm, Xuc, Xuc, Xuc, Mdd^Xm, Xuc, Mdd^Xm, Mdd^Xm, Mdd^Xm, Mdd^Xm, Mdd, Mdd, Mdd, Mdd, Mdd, Mdd, Mdd, Mdd, Hd^Vda, Rd^Br/, Rd^Br/, Dd, Dd, Dd, Dd, Dd, Dd, Dd, Dd, Dd^Edp, Dd^Edpp, Rd, Dd^Edp, Dd, Dd, Dd, Dd, Dd, Dd, Dd, Dd, Dd^Ftd, Dd, Dd^Ftd, Dd^Ftd, Dd, Dd, Dd^Edpp, Dd, Dd, Rd, Rd, Rd, Dd, Dd^Edp, Dd^Edp, Dd, Dd, Dd, Dd, Dd, Dd, Dd
Dd^Br\, Dd, Dd, Dd, Dd, Dd^Edp, Dd^Ftd, Hd, Hd, Hd, Hd, Hd, Hd, Dd, Mdd, Mdd, Mdd, Mdd^Xm, Mdd^Xm, Xuc, Urb, Urb^Ebn, Urb, Xuc, Xuc, Xuc, Xuc, Mdd^Xm, Mdd^Xm, Mdd^Xm, Mdd^Xm, Mdd, Mdd, Mdd, Mdd, Mdd, Mdd, Rd^Br/, Hd, Dd, Hd, Dd, Hd, Hd, Dd, Dd, Dd, Dd, Dd, Dd, Rd, Dd, Dd, Dd, Dd, Dd^Edp, Dd^Ftd, Dd, Dd, Dd, Dd, Dd^Edp, Dd, Dd, Dd, Dd, Dd, Dd^Ftd, Dd^Edpp, Dd, Rd, Rd, Rd, Dd, Rd, Dd, Dd^Ftd, Dd, Dd^Edp, Dd^Edp, Dd^Edp, Dd
Dd, Dd^Br\, Dd^Br\, Dd, Dd^Edpp, Dd^Ftd, Dd^Edp, Dd, Mdd, Hd, Hd, Hd, Dd^Edp, Dd, Mdd, Mdd, Mdd, Mdd^Xm, Mdd^Xm, Xuc, Xuc, Urb, Urb, Uu^Vud, Uu, Xuc, Xuc, Mdd^Xm, Xuc, Xuc, Xuc, Mdd^Xm, Mdd^Xm, Mdd, Mdd, Mdd, Mdd, Mdd, Mdd, Hd, Mdd, Hd, Mdd, Hd, Hd, Dd, Hd, Dd, Dd, Dd, Rd, Dd, Dd^Edp, Dd, Dd, Dd, Dd, Dd, Hd, Dd, Hd, Dd, Hd, Hd, Hd, Hd, Hd, Dd, Dd, Rd, Rd, Rd, Dd^Ftd, Rd, Dd, Rd, Dd, Dd, Dd, Dd, Dd^Edp, Dd
Rd, Dd, Dd, Dd^Br\, Dd^Br\, Dd, Dd^Edp, Mdd, Mdd, Mdd, Dd, Hd, Dd^Br/, Dd^Br/, Mdd, Mdd, Mdd, Mdd, Mdd^Xm, Mdd^Xm, Xuc, Urb^Br\, Uu^Br\, Urb, Uu, Uu, Uu, Xuc^Efs, Uu, Uu, Uu^Vud, Xuc, Xuc, Mdd^Xm, Mdd, Mdd, Mdd, Mdd, Mdd, Mdd, Mdd, Mdd, Mdd, Mdd, Mdd, Hd, Hd, Hd, Hd, Dd, Rd, Dd, Dd, Dd, Dd, Dd, Dd^Edpp, Dd, Hd, Hd, Mdd, Hd, Mdd, Hd, Mdd, Mdd, Mdd, Hd, Hd, Dd^Edp, Rd, Dd, Dd, Dd^Edpp, Dd^Edp, Rd, Dd, Dd^Edp, Dd, Dd, Dd, Dd
Dd, Rd, Rd, Dd, Dd^Vda, Dd^Br\, Dd^Br\, Hd, Hd, Hd, Dd^Br/, Dd^Br/, Dd^Edpp, Dd, Hd, Mdd, Mdd, Mdd, Mdd, Mdd^Xm, Mdd^Xm, Xuc, Xuc, Uu^Br\, Uu^Br\, Uu, Urb, Urb, Uu, Uu, Uu^Br/, Uu^Br/, Xuc, Mdd^Xm, Mdd^Xm, Mdd, Mdd^Xm, Mdd, Mdd, Mdd, Mdd, Mdd, Mdd, Mdd, Mdd, Mdd, Mdd, Hd, Hd, Dd, Rd, Dd, Dd, Dd^Edp, Dd, Dd, Hd, Hd, Mdd, Mdd, Mdd, Mdd, Mdd, Mdd, Mdd, Mdd, Mdd, Mdd, Hd, Dd, Dd, Rd, Dd, Dd^Edp, Rd, Rd, Rd, Dd^Edp, Dd, Dd, Dd, Dd
Dd, Ce, Ce, Rd, Rd, Dd^Ftd, Mdd, Dd^Br\, Dd^Br\, Dd^Br/, Mdd, Dd, Dd, Hd, Hd, Mdd, Mdd, Mdd, Mdd, Mdd^Xm, Mdd^Xm, Mdd^Xm, Mdd^Xm, Xuc, Xuc, Uu^Br\, Urb^Br\, Urb, Uu^Br/, Uu^Br/, Uu, Uu, Xuc, Xuc, Mdd^Xm, Mdd^Xm, Mdd^Xm, Mdd^Xm, Mdd^Xm, Mdd, Mdd^Xm, Mdd, Mdd, Mdd, Mdd, Mdd, Mdd, Mdd, Mdd, Dd, Rd, Dd, Dd, Dd, Dd^Edp, Dd, Hd, Mdd, Mdd, Mdd, Mdd^Xm, Mdd^Xm, Mdd^Xm, Mdd^Xm, Mdd, Mdd, Mdd, Hd, Dd, Rd, Rd, Rd, Rd, Rd, Dd, Rd, Dd, Dd, Dd, Dd, Dd, Dd
Dd^Edpp, Ce, 1 Ke, Ce, Rd, Dd, Dd, Hd, Hd, Hd, Mdd, Dd, Dd^Edpp, Hd, Hd, Hd, Hd, Mdd, Mdd, Mdd, Mdd, Mdd^Xm, Mdd^Xm, Mdd^Xm, Mdd^Xm, Xuc, Xuc, Urb^Br\, Urb^Br\, Urb^Br|, Urb, Urb, Urb, Xuc, Xuc^Efs, Xuc, Xuc, Mdd^Xm, Mdd^Xm, Mdd^Xm, Mdd^Xm, Mdd^Xm, Mdd, Mdd, Mdd, Mdd, Mdd, Mdd, Mdd, Dd, Rd, Dd^Ftd, Dd, Dd, Dd, Dd, Hd, Mdd, Mdd, Mdd, Mdd^Xm, Mdd^Xm, Mdd^Xm, Mdd^Xm, Mdd, Mdd, Mdd, Hd, Dd, Dd, Dd, Rd, Dd^Edp, Rd, Dd, Dd, Dd^Edpp, Dd, Dd, Dd, Dd, Dd
Dd^Ftd, Ce, Ce, Ce, Dd^Ftd, Rd, Rd, Mdd, Mdd, Mdd, Dd, Dd^Edpp, Dd, Dd, Hd, Hd, Hd, Hd, Mdd, Mdd, Mdd, Mdd^Xm, Mdd^Xm, Mdd^Xm, Mdd^Xm, Mdd^Xm, Xuc, Uu, Uu, Uu^Br\, Uu^Br\, Urb, Urb, Uu, Uu, Uu, Uu, Xuc, Xuc, Mdd^Xm, Mdd^Xm, Mdd^Xm, Mdd^Xm, Mdd, Mdd, Mdd, Mdd, Mdd, Mdd, Rd, Dd^Edpp, Rd, Dd, Dd, Dd, Dd, Hd, Mdd, Mdd, Mdd, Mdd, Mdd^Xm, Mdd, Mdd^Xm, Mdd, Mdd, Mdd, Dd, Dd^Edp, Dd, Dd, Dd, Dd, Dd, Dd, Dd, Dd, Dd, Dd, Dd, Dd, Dd^Ftd
Dd, Dd^Vdt, Dd^Edpp, Ce, Dd^Edpp, Dd^Vdt, Dd, Rd, Rd, Dd, Dd, Dd^Edpp, Dd, Dd, Dd, Hd, Hd, Hd, Mdd, Mdd, Mdd, Mdd, Mdd, Mdd^Xm, Mdd^Xm, Mdd^Xm, Mdd^Xm, Xuc, Xuc, Uu^Ebn, Xuc, Uu^Br\, Urb^Br\, Urb, Urb, Urb, Urb, Urb, Urb, Xuc, Xuc, Mdd^Xm, Mdd^Xm, Mdd^Xm, Mdd, Mdd, Mdd, Mdd, Mdd, Mdd, Dd^Edp, Rd, Dd^Edp, Dd^Edp, Dd, Dd^Edp, Hd, Hd, Mdd, Mdd, Mdd, Mdd, Mdd, Mdd, Mdd, Mdd, Hd, Hd, Dd, Dd^Edpp, Dd, Dd^Edp, Dd, Dd, Dd, Dd, Dd, Dd^Edp, Rd, Rd, Rd, Rd
Dd, Dd, Dd, Dd^Edp, Dd, Dd, Dd, Dd, Rd, Dd, Dd^Edp, Dd, Dd, Dd, Dd, Dd, Dd^Edpp, Hd, Dd, Mdd, Mdd, Mdd, Mdd, Mdd, Mdd, Mdd^Xm, Mdd^Xm, Mdd^Xm, Mdd^Xm, Xuc, Xuc, Xuc, Xuc, Urb^Br\, Uu^Br\, Uu, Uu, Urb, Urb^Br/, Urb, Uu, Xuc, Xuc, Mdd^Xm, Mdd^Xm, Mdd, Mdd, Mdd, Mdd, Mdd, Dd^Ftd, Rd, Dd, Dd, Dd^Edpp, Dd, Dd, Hd, Mdd, Mdd, Mdd, Mdd, Mdd, Mdd, Mdd, Mdd, Hd, Dd, Dd, Dd, Dd^Ftd, Dd^Edp, Dd, Dd, Dd, Dd, Dd^Edp, Rd, Dd, Dd, Dd, Dd
Dd, Dd, Dd, Dd, Dd, Dd, Dd, Dd, Dd^Edpp, Rd, Rd, Dd, Dd^Ftd, Dd, Dd, Dd^Ftd, Dd^Edp, Dd, Dd^Edp, Dd, Dd, Mdd, Mdd, Mdd, Mdd, Mdd, Mdd, Mdd^Xm, Mdd^Xm, Mdd^Xm, Mdd^Xm, Mdd^Xm, Mdd^Xm, Xuc, Xuc, Uu^Br\, Uu^Br\, Uu^Br/, Uu, Urb^Br\, Uu^Br/, Uu^Br/, Xuc, Mdd^Xm, Mdd^Xm, Mdd^Xm, Mdd^Xm, Mdd, Mdd, Mdd, Hd, Rd, Dd, Dd, Dd, Dd, Dd, Hd, Dd^Edp, Mdd, Mdd, Mdd, Hd, Mdd, Hd, Hd, Dd, Dd^Edp, Dd, Dd, Dd, Dd, Dd, Dd^Edpp, Dd, Dd, Rd, Rd, Dd^Edp, Dd, Dd, Dd
Dd, Dd^Edpp, Dd, Dd^Edp, Dd, Dd^Edp, Dd, Dd^Edpp, Dd, Dd^Vda, Dd, Rd, Rd, Dd, Dd, Dd^Dc, Dd, Dd^Edpp, Dd, Dd, Dd, Dd, Mdd, Mdd, Mdd, Mdd, Mdd, Mdd, Mdd, Mdd, Mdd, Mdd^Xm, Mdd^Xm, Mdd^Xm, Mdd^Xm, Xuc, Xuc, Uu^Br\, Uu^Br|, Urb, Urb, Uu, Uu, Xuc, Mdd^Xm, Mdd^Xm, Mdd^Xm, Mdd, Mdd, Mdd, Hd, Rd, Dd^Edp, Dd, Dd^Edpp, Dd^Edp, Dd, Dd, Dd, Dd, Dd, Hd, Dd, Hd, Dd, Dd^Edp, Dd^Edpp, Dd, Dd, Dd, Dd^Edp, Dd, Dd, Dd, Dd, Dd^Edp, Rd, Dd, Dd, Dd, Dd, Dd
Dd, Dd, Dd, Dd, Dd, Dd, Dd, Dd, Dd, Dd, Dd, Dd^Edp, Dd, Rd, Rd, Rd, Rd, Dd^Edp, Dd, Dd, Dd^Edpp, Dd^Edp, Dd, Mdd, Mdd, Mdd, Mdd, Mdd, Mdd, Mdd, Mdd, Mdd, Mdd, Mdd^Xm, Mdd^Xm, Mdd^Xm, Xuc, Uu, Uu^Br|, Uu, Urb, Uu, Uu, Xuc, Mdd^Xm, Mdd^Xm, Mdd, Mdd, Mdd, Mdd, Hd, Rd, Dd, Dd, Dd^Edp, Dd, Dd, Dd, Dd, Dd, Dd, Dd, Dd, Dd^Edp, Dd, Dd^Edp, Dd, Dd, Dd, Dd, Dd, Dd^Edp, Dd, Dd, Rd, Rd, Dd^Ftd, Dd^Edp, Dd, Dd^Edp, Dd, Dd
Dd, Dd, Dd, Dd, Dd^Edp, Dd, Dd, Dd, Dd, Dd^Ftd, Dd^Edpp, Dd, Dd, Dd, Dd, Dd^Edpp, Rd, Dd^Edp, Dd^Edp, Dd, Dd, Dd, Dd, Dd^Edp, Dd^Edp, Dd^Edpp, Hd, Hd, Hd, Mdd, Mdd, Mdd, Mdd, Mdd^Xm, Mdd^Xm, Mdd^Xm, Xuc, Uu^Vud, Xuc, Xuc, Xuc, Uu^Ebn, Xuc, Xuc, Mdd^Xm, Mdd^Xm, Mdd, Mdd, Mdd, Hd, Hd, Rd, Dd, Dd, Dd^Edp, Dd, Dd^Edp, Dd, Dd^Edpp, Dd, Dd, Dd, Dd, Dd^Edp, Dd, Dd, Dd, Dd, Dd, Dd, Dd, Dd, Rd, Rd, Rd, Dd^Edp, Dd, Dd, Dd^Edp, Dd, Dd, Dd
Dd, Dd, Dd, Dd, Dd, Dd, Dd, Dd, Dd, Dd^Edp, Dd, Dd, Dd^Dc, Dd, Dd, Dd^Edp, Rd, Rd, Dd^Vda, Dd, Dd^Ftd, Dd, Dd, Dd, Dd, Hd, Hd, Hd, Hd, Hd, Mdd, Mdd, Mdd, Mdd^Xm, Mdd, Mdd^Xm, Mdd^Xm, Xuc, Mdd^Xm, Mdd^Xm, Mdd^Xm, Xuc, Mdd^Xm, Mdd^Xm, Mdd^Xm, Mdd, Mdd, Mdd, Mdd, Hd, Dd^Ftd, Rd, Rd, Dd, Dd, Dd^Edp, Dd, Dd, Dd^Edp, Dd, Dd^Edp, Dd, Dd, Dd^Edpp, Dd, Dd^Edp, Dd, Dd, Rd, Rd, Rd, Rd, Dd, Dd^Vda, Dd, Dd, Dd, Dd, Dd, Dd, Dd^Edp, Dd
Dd, Dd, Dd, Dd, Dd, Dd^Edpp, Rd, Dd, Dd, Dd, Dd^Edp, Dd^Ftd, Rd, Rd, Rd, Dd, Dd, Rd, Rd, Dd, Dd^Edp, Dd^Edp, Dd, Dd^Edpp, Dd, Dd, Dd, Hd, Hd, Hd, Hd, Mdd, Mdd, Mdd, Cd, Mdd, Mdd, Mdd, Mdd, Mdd^Xm, Mdd, Mdd^Xm, Mdd^Xm, Mdd^Xm, Mdd, Mdd, Mdd, Mdd, Hd, Hd, Dd, Dd, Rd, Dd, Dd, Dd^Edpp, Dd, Dd^Edp, Dd^Edp, Dd, Dd, Dd, Dd, Dd, Dd, Dd, Rd, Rd, Dd, Rd, Dd, Dd, Dd, Dd, Dd, Dd, Dd, Dd, Dd, Dd, Dd^Ftd, Dd
Dd^Edp, Dd, Dd^Edpp, Dd^Edpp, Dd^Edpp, Rd, Rd, Rd, Rd, Rd, Rd, Rd, Rd, Rd, Dd, Dd, Dd, Dd^Edpp, Rd, Dd^Ftd, Dd, Dd, Dd, Dd, Dd, Dd, Dd, Dd, Dd^Ftd, Hd, Hd, Hd, Mdd, Mdd, Cd, Mdd, Mdd, Mdd, Mdd, Mdd, Mdd, Mdd, Mdd, Mdd, Cd, Mdd, Mdd, Mdd, Hd, Dd^Edp, Dd, Dd, Rd, Dd, Dd^Edp, Dd, Dd, Dd, Dd, Dd^Ftd, Dd, Dd, Rd, Rd, Rd, Rd, Dd^Ftd, Dd^Edp, Dd^Edp, Dd, Dd^Ftd, Dd, Dd, Dd, Dd, Dd, Dd, Dd, Dd, Dd, Dd, Dd^Edp
Dd, Dd, Dd^Ftd, Dd^Edpp, Dd^Ftd, Rd, Dd, Rd, Dd^Edp, Rd, Dd, Rd, Dd, Dd, Dd^Edpp, Dd, Dd, Dd, Dd, Rd, Dd, Dd, Dd^Edp, Dd, Dd, Dd^Edp, Dd, Dd, Dd^Ftd, Dd, Dd, Dd, Dd^Edpp, Mdd, Cd, Mdd, Mdd, Rd, Mdd, Mdd, Mdd, Mdd, Mdd, Mdd, Cd, Mdd, Dd, Dd^Edpp, Dd, Dd, Dd, Dd, Rd, Dd^Edpp, Dd^Edpp, Dd, Dd, Dd, Dd, Dd, Rd, Rd, Dd^Vda, Rd, Dd^Edpp, Dd, Dd, Dd, Dd, Dd, Dd, Dd, Dd, Dd, Dd, Dd^Edp, Dd, Dd, Dd, Dd, Dd, Dd
Dd, Dd, Dd, Dd, Dd, Dd, Dd, Dd, Dd, Dd, Dd^Edpp, Dd, Dd^Edpp, Dd^Ftd, Dd, Dd, Dd, Dd, Dd, Rd, Rd, Dd, Dd, Dd^Ftd, Dd, Dd, Dd, Dd^Edpp, Dd, Dd, Dd, Dd, Cd, Cd, Cd, Hd, Dd^Vda, Rd, Dd^Vda, Mdd, Rd, Mdd, Mdd, Mdd, Cd, Cd, Cd, Dd, Dd^Ftd, Dd, Dd, Dd, Rd, Dd, Rd, Dd^Vda, Rd, Rd, Rd, Rd, Dd, Dd, Dd^Edp, Dd, Dd, Dd, Dd, Dd, Dd, Dd, Dd, Dd, Dd, Dd, Dd, Dd, Dd, Dd, Dd, Dd^Edpp, Dd, Dd
Dd^Edp, Dd^Ftd, Dd, Dd, Dd, Dd, Dd, Dd, Dd, Dd^Edp, Dd^Edp, Dd, Dd, Dd, Dd, Dd, Dd, Dd, Dd, Dd^Edpp, Rd, Dd, Dd, Dd, Dd, Dd, Dd, Dd^Ftd, Dd, Dd^Vdt, Dd, Dd, Cd, 2 Kd, Cd, Dd, Rd, Rd, Dd, Hd, Rd, Dd^Vda, Dd, Hd, Cd, 3 Kd, Cd, Dd, Dd, Dd, Rd, Rd, Dd^Edp, Rd, Rd, Rd, Rd, Rd, Dd, Dd, Dd, Dd, Dd, Dd, Dd, Dd, Dd^Edp, Dd, Dd, Dd, Dd, Dd^Edp, Dd, Dd, Dd^Ftd, Dd^Ftd, Dd, Dd^Edp, Dd, Dd, Dd^Ftd, Dd
Dd, Dd, Dd^Edpp, Dd, Dd^Ftd, Dd, Dd, Dd, Dd^Edp, Dd^Ftd, Dd, Dd, Dd^Edp, Dd, Dd, Dd, Dd, Dd^Edpp, Dd, Ce, 6 Ke, Rd, Rd, Dd, Dd, Dd, Dd, Dd, Dd^Edp, Dd, Dd, Dd^Ftd, Dd, Cd, Cd, Rd, Dd, Dd^Vda, Dd, Dd^Do, Dd, Rd, Rd, Dd, Cd, Cd, Dd, Dd^Edpp, Dd, Rd, Rd, Dd, Dd, Dd, Dd, Dd, Dd^Ftd, Dd, Dd, Dd^Edp, Dd, Dd, Dd, Dd^Edpp, Dd, Dd, Dd^Edp, Dd^Edp, Dd, Dd, Dd, Dd, Dd, Dd^Ftd, Dd, Dd, Dd, Dd^Edp, Dd^Ftd, Dd, Dd, Dd
Dd, Dd, Dd, Dd^Edp, Dd, Dd^Edpp, Dd^Edp, Dd, Dd, Dd^Ftd, Dd^Edpp, Dd^Ftd, Dd, Dd^Edp, Dd, Dd, Dd^Edpp, Dd, Dd, Ce, Ce, Ce, Hd, Rd, Rd, Dd, Dd^Edp, Dd, Dd, Dd^Edpp, Dd^Ftd, Dd, Dd^Edpp, Dd^Edp, Cd, Rd, Dd^Do, Dd, Ww, Ww, Ww, Dd^Vda, Dd^Do, Rd, Cd, Rd, Dd^Vdt, Dd, Rd, Rd, Dd, Dd, Dd, Dd^Edp, Dd, Dd, Dd, Dd, Dd, Dd, Dd, Dd^Edpp, Dd, Dd, Dd, Dd, Dd^Edpp, Dd, Dd^Edpp, Dd, Dd, Dd^Edp, Dd^Edpp, Dd, Dd, Dd^Edp, Dd, Dd, Dd^Edpp, Dd^Edpp, Dd, Dd
Dd, Dd^Edpp, Dd^Edp, Dd, Dd, Dd^Edp, Dd, Dd, Dd^Edp, Dd, Dd^Edpp, Dd^Ftd, Dd^Ftd, Dd, Dd^Edp, Dd^Edp, Dd^Edpp, Dd, Dd, Dd^Edpp, Dd, Hd, Hd, Hd, Hd, Rd, Rd, Rd, Rd, Dd^Edpp, Rd, Dd, Rd, Dd, Rd^Br|, Cd, Cd, Ww, Wo, Wo, Wo, Ww, Cd, Cd, Dd, Rd, Rd, Rd, Dd, Dd, Dd^Edpp, Dd, Dd^Ftd, Dd^Edpp, Dd, Dd^Edpp, Dd, Dd, Dd, Dd, Dd, Dd, Dd^Edp, Dd, Dd, Dd, Dd, Dd, Dd^Edp, Dd, Dd^Edpp, Dd, Dd, Dd, Dd^Edp, Dd^Edp, Dd, Dd^Edp, Dd, Dd, Dd, Dd^Edp
Dd, Dd^Ftd, Dd, Dd, Dd, Dd^Edpp, Dd, Dd, Dd, Dd, Dd, Dd^Do, Rd, Rd, Rd, Dd, Dd^Edp, Dd, Dd, Dd^Edpp, Dd^Ftd, Hd, Hd, Hd, Hd, Hd, Rd, Hd^Vda, Rd, Rd, Hd, Rd, Rd, Rd, Dd^Br|, Dd^Ftd, Ww, Cd, Cd, Wo, Cd, Cd, Ww, Dd^Ftd, Dd^Ftd, Dd, Dd, Rd, Rd, Dd, Rd, Dd, Dd^Edp, Dd, Dd, Dd^Ftd, Dd^Ftd, Dd^Ftd, Dd^Ftd, Dd, Dd^Ftd, Dd, Dd, Dd, Dd, Dd, Dd, Dd, Dd^Ftd, Dd, Dd^Dc, Dd, Dd, Dd, Dd^Edp, Dd, Dd, Dd, Dd, Dd, Dd^Edp, Dd
Dd, Dd, Dd, Dd, Dd^Ftd, Dd, Dd, Dd^Dc, Dd, Dd^Edp, Rd, Rd, Ww, Hd, Hd, Rd, Rd, Dd, Rd, Dd^Ftd, Rd, Hd, Rd, Hd, Rd, Rd, Hd, Rd, Hd, Hd, Rd, Rd, Dd^Edpp, Dd^Ftd, Dd^Br|, Dd^Ftd, Ww, Wo, Wo, Cd, Wo, Wo, Ww, Dd^Ftd, Dd^Ftd, Dd, Dd^Edpp, Dd, Dd, Rd, Rd, Dd, Dd, Dd^Edp, Dd, Dd^Ftd, Dd^Ftd, Dd^Ftd, Dd^Ftd, Dd^Ftd, Dd^Ftd, Dd^Ftd, Dd^Ftd, Dd^Edpp, Dd, Dd^Edpp, Dd, Dd^Ftd, Dd, Dd, Dd, Dd, Dd, Dd, Dd^Edp, Dd, Dd^Edp, Dd^Edpp, Dd, Dd, Dd, Dd
Dd, Dd, Dd^Ftd, Dd^Ftd, Dd^Ftd, Dd^Ftd, Dd, Dd, Rd, Rd, Hd^Ftd, Ww, Ww, Ww, Hd, Hd, Dd^Ftd, Rd, Dd^Ftd, Rd, Dd, Rd, Dd, Rd, Dd, Dd, Dd, Hd, Dd^Ftd, Hd, Rd, Dd, Dd^Ftd, Dd, Dd^Br|, Dd^Do, Ww, Wo, Wo, Wo, Wo, Wo, Ww, Dd^Ftd, Dd^Ftd, Dd, Dd, Dd, Dd, Dd, Dd, Rd, Rd, Dd^Edp, Dd^Ftd, Dd^Ftd, Ww, Ww, Ww, Dd^Do, Ww, Dd^Ftd, Dd^Ftd, Dd, Dd^Ftd, Dd, Dd, Dd^Edpp, Dd, Dd, Dd, Dd, Dd, Dd, Dd, Dd, Dd, Dd, Dd, Dd, Dd, Dd
Dd, Dd^Edpp, Dd^Ftd, Dd^Ftd, Dd^Do, Dd^Ftd, Rd, Rd, Dd^Ftd, Dd^Vda, Dd^Ftd, Hd^Ftd, Hd^Ftd, Hd, Dd^Ftd, Dd^Ftd, Dd^Ftd, Dd, Dd, Dd, Dd, Dd, Dd, Dd, Dd, Dd, Dd^Ftd, Dd^Ftd, Dd, Hd, Rd, Dd, Dd, Dd, Dd^Br|, Dd^Ftd, Dd^Ftd, Ww, Ww, Wo, Ww, Ww, Dd^Do, Dd^Ftd, Dd^Ftd, Dd, Dd^Edp, Dd^Edp, Dd, Dd^Edpp, Dd, Rd, Rd, Dd, Dd^Ftd, Dd^Ftd, Ww, Ww, Ww, Ww, Ww, Dd^Ftd, Dd^Ftd, Dd, Dd, Dd^Ftd, Dd, Dd, Dd, Dd, Dd, Dd^Edpp, Dd, Dd, Dd^Vdt, Dd, Dd, Dd, Dd^Edpp, Dd, Dd, Dd^Edp
Dd^Edpp, Dd^Vda, Rd, Rd, Rd, Rd, Dd, Dd^Ftd, Dd^Ftd, Dd^Ftd, Dd^Ftd, Dd^Ftd, Dd^Ftd, Dd^Ftd, Dd^Ftd, Dd^Ftd, Dd^Ftd, Dd^Ftd, Dd, Dd^Edp, Dd, Dd^Edp, Dd, Dd, Dd^Edp, Dd, Dd^Edpp, Dd, Dd^Edp, Dd, Rd, Dd^Edpp, Dd, Dd, Dd^Br|, Dd^Ftd, Dd^Ftd, Dd^Ftd, Dd^Ftd, Ww, Dd^Ftd, Dd^Ftd, Dd^Ftd, Dd^Ftd, Dd^Edpp, Dd, Dd^Edp, Dd^Edp, Dd, Dd, Dd^Edpp, Dd^Vda, Dd, Rd, Rd, Dd^Ftd, Hd^Ftd, Ww, Hd^Ftd, Ww, Hd^Ftd, Dd^Ftd, Dd^Ftd, Dd^Ftd, Dd, Dd, Dd^Edp, Dd^Edp, Dd, Dd^Edpp, Dd^Edp, Dd, Dd, Dd, Ce, Dd^Edp, Dd^Edpp, Dd, Dd, Dd, Dd, Dd^Dc
Dd^Dc, Rd, Hd, Hd, Hd, Hd, Dd, Dd^Ftd, Dd^Ftd, Dd^Ftd, Dd, Dd, Dd, Dd, Dd, Dd, Dd, Dd, Dd, Dd, Dd, Dd^Edp, Dd^Edp, Dd^Ftd, Dd, Dd, Dd, Dd, Dd, Dd, Hd, Rd, Dd, Dd, Dd^Br|, Dd^Edp, Dd^Edpp, Dd^Ftd, Dd^Ftd, Dd^Ftd, Dd, Dd^Ftd, Dd, Dd^Edp, Dd^Ftd, Dd^Ftd, Dd, Dd, Dd, Dd, Dd, Dd^Edpp, Dd, Rd, Rd, Hd^Ftd, Hd, Mdd, Mdd, Mdd, Mdd, Hd^Ftd, Dd, Dd, Dd, Dd, Dd, Dd, Dd, Dd, Dd, Dd^Vdt, Ce, Ce, Ce, Ce, Ce, Dd^Vdt, Dd, Dd^Edpp, Dd, Dd
Rd, Rd, Mdd, Mdd, Dd^Edpp, Dd, Dd, Dd^Edp, Dd^Ftd, Dd, Dd, Dd, Dd, Dd^Edp, Dd, Dd^Edp, Dd^Ftd, Dd, Dd, Dd, Dd^Edp, Dd, Dd, Dd, Dd^Edpp, Dd, Dd, Hd, Mdd, Mdd, Hd, Rd, Dd, Dd, Dd^Br|, Dd, Dd, Dd^Ftd, Dd, Dd^Ftd, Rd, Rd, Rd, Dd^Edp, Dd, Dd, Rd, Rd, Rd, Dd, Dd, Dd, Dd^Edpp, Dd^Edp, Dd, Rd, Hd, Mdd, Mdd, Mdd, Hd, Hd, Mdd, Mdd, Mdd, Dd, Rd, Rd, Rd, Dd, Rd, Dd^Edp, Ce, Ce, 4 Ket, Ce, Ce, Dd, Dd, Dd, Dd, Dd
Mdd, Mdd, Hd, Hd, Dd, Dd, Dd^Ftd, Dd, Dd, Dd^Edp, Dd^Edpp, Dd, Dd^Edpp, Dd, Dd, Dd^Ftd, Dd, Dd, Dd^Ftd, Dd^Edp, Dd^Edpp, Dd, Dd^Edpp, Dd, Dd, Dd, Dd, Mdd, Mdd, Mdd, Hd, Rd, Dd, Dd, Dd^Br|, Dd^Edp, Dd, Dd, Rd, Rd, Rd, Dd^Ftd, Rd, Dd, Rd, Dd^Ftd, Rd, Dd^Ftd, Dd^Edpp, Rd, Rd, Dd^Ftd, Dd, Dd, Dd^Edp, Rd, Rd, Hd, Hd, Hd^Vda, Rd, Dd^Edp, Rd, Cdr, Rd, Rd, Dd, Dd, Dd, Rd, Rd, Rd, Rd, Rd, Rd, Rd, Rd, Rd, Rd, Rd, Rd, Rd
Mdd, Mdd, Mdd, Dd, Dd^Edp, Dd^Edp, Dd, Dd^Edp, Dd, Dd^Ftd, Dd^Dc, Dd, Dd, Dd, Dd^Ftd, Dd, Dd, Dd, Dd^Edp, Dd, Dd^Edpp, Dd, Dd, Dd, Dd, Dd, Dd^Ftd, Dd, Hd, Hd, Rd, Rd, Dd^Vda, Dd^Edp, Dd^Br|, Dd, Dd, Dd, Hd, Rd, Dd, Dd, Hd, Rd, Rd, Rd, Rd, Dd, Dd, Rd, Rd, Dd, Rd, Dd, Dd, Hd, Hd, Rd, Rd, Rd, Rd, Rd, Hd, Rd, Hd, Dd^Ftd, Dd, Dd^Dc, Dd, Dd, Dd, Dd^Edpp, Dd, Dd^Vdt, Dd, Dd^Vdt, Dd^Edp, Dd^Ftd, Dd^Edp, Dd, Dd^Edp, Dd^Ftd
Mdd, Mdd, Mdd, Dd, Dd, Dd^Edp, Dd, Dd^Edpp, Dd, Dd, Dd, Dd^Edp, Dd^Edp, Dd, Dd, Dd, Dd, Dd^Edp, Dd, Dd^Ftd, Dd, Dd, Dd^Edp, Dd^Edpp, Dd, Dd, Dd, Dd^Edpp, Rd, Rd, Dd, Dd^Edp, Dd, Dd, Dd^Br|, Dd, Hd, Hd, Mdd, Hd, Hd, Hd, Hd, Hd, Hd, Dd, Dd, Dd, Dd, Dd^Ftd, Dd, Rd, Rd, Dd, Dd, Dd^Edpp, Mdd, Hd, Mdd, Hd, Hd, Hd, Hd, Hd, Dd, Dd^Edp, Dd, Dd, Dd, Dd, Dd, Dd, Dd, Dd, Dd, Dd, Dd, Dd, Dd, Dd, Dd, Dd
Mdd, Mdd, Mdd, Mdd, Dd^Edpp, Dd^Edpp, Dd, Dd, Dd, Dd, Dd^Dc, Dd, Dd, Dd, Dd, Dd, Rd, Dd, Dd, Dd, Dd^Edp, Dd, Dd, Dd^Edp, Dd, Dd^Edp, Dd, Rd, Hd, Dd, Dd^Edpp, Dd, Dd, Dd, Dd^Br|, Dd^Ftd, Dd, Hd, Mdd, Mdd, Mdd, Mdd, Hd, Mdd, Mdd, Hd, Dd, Dd, Dd^Edp, Dd, Dd, Dd, Dd^Edp, Rd, Dd^Edpp, Dd^Edp, Dd, Mdd, Dd, Mdd, Dd, Dd, Dd, Dd, Dd, Dd^Ftd, Dd, Dd, Dd, Dd, Dd^Edp, Dd, Dd, Dd^Edp, Dd, Dd, Dd, Dd, Dd, Dd, Dd, Dd
Mdd, Mdd, Mdd, Mdd, Dd, Dd^Edp, Rd, Rd, Rd, Rd, Rd, Dd^Edpp, Rd, Rd, Rd, Rd, Dd, Dd, Dd^Edpp, Dd^Edpp, Dd^Edp, Dd, Dd^Edp, Dd^Edpp, Dd, Dd, Rd, Rd, Hd, Dd, Dd, Dd, Dd, Dd, Dd^Br|, Dd, Mdd, Hd, Hd, Hd, Hd, Mdd, Hd, Hd, Hd, Hd, Dd^Edp, Dd, Dd^Ftd, Dd^Edp, Dd, Dd^Edp, Dd, Rd, Rd, Rd, Rd, Dd, Dd, Dd, Dd^Edpp, Dd, Dd, Dd^Ftd, Dd, Dd, Dd, Dd, Dd^Edpp, Dd^Edp, Dd, Dd, Dd, Dd, Dd^Ftd, Dd, Dd, Dd, Dd, Dd, Dd^Edp, Dd^Edp
Mdd, Mdd, Mdd, Mdd, Dd, Dd, Rd, Rd, Dd^Edp, Rd, Dd^Ftd, Rd, Rd, Dd, Dd^Edp, Dd, Rd, Rd, Dd, Dd, Dd^Edp, Dd, Dd^Edp, Dd, Dd, Dd, Rd, Mdd, Mdd, Hd, Hd, Dd, Dd^Edpp, Dd^Edp, Dd^Br|, Mdd, Mdd, Mdd, Dd^Edp, Hd, Dd, Hd, Dd, Dd^Edp, Dd, Dd, Dd, Dd, Dd, Dd, Dd, Dd, Dd^Ftd, Rd, Rd, Rd, Dd, Dd, Dd^Ftd, Dd, Dd, Dd, Dd, Dd^Ftd, Dd, Dd, Dd^Edp, Dd, Dd, Dd, Dd, Dd, Dd, Dd^Edp, Dd, Dd, Dd, Dd, Dd, Dd, Dd, Dd
Dd, Dd, Dd^Edp, Dd^Edp, Dd, Dd, Rd, Rd, Dd^Edp, Dd^Ftd, Rd, Rd, Rd, Dd, Rd, Dd, Rd, Dd, Dd, Dd, Dd^Edpp, Dd, Dd, Dd, Dd^Edpp, Dd, Rd, Mdd, Mdd, Mdd, Hd, Dd^Ftd, Dd, Dd, Dd^Br|, Dd^Br\, Dd^Br\, Mdd, Dd, Dd, Dd, Dd, Dd, Dd, Dd, Dd, Dd, Dd, Dd, Dd, Dd, Dd, Dd^Ftd, Dd, Dd^Edpp, Dd^Edp, Dd, Dd^Dc, Dd^Ftd, Dd, Dd, Dd, Dd^Edp, Dd, Dd, Dd, Dd^Edp, Dd, Dd, Dd, Dd, Dd, Dd^Edpp, Dd^Edp, Dd, Dd, Dd^Edpp, Dd, Dd^Edpp, Dd, Dd, Dd
Dd, Dd^Edp, Dd, Dd^Edp, Dd, Dd^Edpp, Rd, Rd, Dd^Edp, Rd, Rd, Rd, Rd, Rd, Rd, Rd, Dd, Dd, Dd, Dd^Ftd, Dd, Dd, Dd, Dd, Dd, Dd, Rd, Hd, Hd, Mdd, Dd^Ftd, Dd, Dd, Dd, Dd^Br|, Dd^Vda, Dd^Edpp, Dd^Br\, Dd^Br\, Dd^Ftd, Dd, Dd, Dd, Dd^Edp, Dd, Dd^Edp, Dd, Dd, Dd, Dd, Dd^Edp, Dd, Dd, Dd, Dd, Dd, Dd, Dd, Dd, Dd, Dd, Dd, Dd^Edp, Dd, Dd, Dd, Dd, Dd, Ce, Ce, Ce, Dd^Vdt, Dd, Dd, Dd^Edp, Dd, Dd, Dd^Edpp, Dd^Edpp, Dd, Dd, Dd
Dd, Dd, Dd, Dd, Dd, Dd, Dd^Edpp, Dd^Dc, Rd, Rd, Dd, Dd, Dd^Edp, Dd, Dd, Dd, Dd, Dd, Dd, Dd^Ftd, Dd, Dd^Edp, Dd, Dd, Dd, Dd, Rd, Hd, Dd, Hd, Dd, Dd, Dd, Dd, Dd^Br|, Dd, Dd^Edpp, Dd^Ftd, Dd, Dd^Br\, Dd^Br\, Dd, Dd^Edp, Dd, Dd, Dd, Dd, Dd, Dd, Dd^Ftd, Dd^Dc, Dd, Dd^Ftd, Dd, Dd, Dd, Dd, Dd, Dd, Dd, Dd, Dd, Dd, Dd, Dd, Dd, Dd^Edpp, Dd^Vdt, Ce, 5 Ke, Ce, Dd, Dd, Dd^Edpp, Dd, Dd, Dd, Dd, Dd, Dd, Dd, Dd
Dd, Dd, Dd, Dd, Dd, Rd, Rd, Rd, Rd, Rd, Dd, Dd^Edp, Dd^Edp, Dd, Dd, Dd, Dd, Dd^Edp, Dd^Edpp, Dd^Edp, Dd, Dd, Dd, Dd, Dd^Edp, Dd, Dd^Vda, Rd, Dd, Dd, Dd^Edpp, Dd, Dd^Edp, Dd^Ftd, Dd^Br|, Dd, Dd, Dd, Dd, Dd, Dd, Dd^Br\, Dd^Br\, Dd, Dd, Dd, Dd, Dd, Dd, Dd^Edp, Dd, Dd, Dd, Dd, Dd^Edp, Dd, Dd, Dd, Dd, Dd, Dd^Edpp, Dd, Dd, Dd, Dd, Dd^Edp, Dd, Dd, Dd, Ce, Dd, Dd, Dd, Dd, Dd^Edp, Dd, Dd, Dd, Dd, Dd, Dd, Dd
Dd^Edp, Dd, Dd, Dd, Dd, Dd^Edp, Dd, Dd, Dd, Dd, Dd^Edp, Dd^Edp, Dd^Edp, Dd, Dd^Edp, Dd, Dd, Dd, Dd, Dd, Dd^Edpp, Dd, Dd^Dc, Dd, Dd^Edp, Dd, Dd, Rd, Rd, Dd, Dd^Edp, Dd, Dd, Dd, Dd^Br|, Dd, Dd, Dd, Dd^Ftd, Dd^Ftd, Dd, Dd^Edp, Dd, Dd^Br\, Dd^Br\, Dd, Dd, Dd, Dd^Edp, Dd, Dd^Edp, Dd, Dd, Dd, Dd^Ftd, Dd^Edpp, Dd, Dd, Dd, Dd, Dd, Dd, Dd^Edp, Dd^Ftd, Dd, Dd^Edpp, Dd, Dd, Dd, Dd, Dd, Dd^Edp, Dd, Dd, Dd, Dd, Dd, Dd^Edp, Dd, Dd, Dd, Dd
