Hd, Hd, Hd, Hd, Dd^Edpp, Dd, Dd^Edpp, Dd^Ftd, Dd, Dd, Dd^Edp, Dd, Dd, Dd^Ftd, Dd, Dd^Edp, Dd, Dd, Dd^Ftd, Dd, Hd, Hd, Hd, Hd, Hd, Dd
Hd, Hd, Hd, Hd, Dd, Dd, Dd^Ftd, Dd, Dd^Ftd, Dd^Edpp, Dd, Dd, Dd, Dd^Ftd, Kd, Dd^Edp, Dd^Ftd, Dd, Dd, Dd, Dd, Hd, Dd, Hd, Hd, Hd
Hd, Hd, Dd^Edp, Dd^Edpp, Dd, Dd, Dd^Ftd, Dd, Dd^Ftd, Dd, Dd^Edp, Dd, Dd, Dd^Edp, Dd, Dd^Ftd, Dd, Dd, Kd, Dd, Dd^Edp, Dd, Dd^Edp, Dd, Dd^Ftd, Dd^Edp
Dd, Dd, Dd, Dd^Edp, Dd^Edp, Dd, Kd, Dd, Dd, Kd, Dd, Dd, Dd^Do, Dd^Edpp, Ww, Dd^Vda, Dd^Edp, Dd, Dd^Ftd, Dd^Ftd, Dd, Dd, Dd, Dd^Ftd, Dd, Dd
Dd, Dd^Edp, Dd, Dd^Edpp, Dd, Dd^Edpp, Dd^Edpp, Dd^Edp, Dd^Edpp, Dd, Ww, Ww, Ww, Ww, Ww, Ww, Ww, Dd, Dd^Vda, Dd, Kd, Dd^Ftd, Dd, Dd, Dd, Dd^Edp
Dd, Dd, Dd, Kd, Dd, Dd, Dd, Dd^Vda, Ww, Ww, Ww, Ww, Ww, Ww, Wo, Ww, Ww, Ww, Dd, Dd^Edp, Dd^Ftd, Dd^Edpp, Dd, Dd, Dd^Edp, Dd
Dd, Dd, Dd^Edp, Dd^Edpp, Dd^Ftd, Dd, Dd, Ww, Ww, Ww, Wo, Wo, Wo, Wo, Wo, Wo, Ww, Ww, Dd^Do, Dd^Edp, Dd^Ftd, Dd, Dd^Ftd, Dd^Edp, Dd, Dd^Ftd
Dd, Dd^Ftd, Dd^Vda, Dd, Dd^Edp, Dd, Dd^Edpp, Ww, Ww, Wo, Wo, Wo, Wo, Wo, Ww, Wo, Ww, Ww, Dd, Dd^Ftd, Dd^Edpp, Kd, Dd, Dd^Ftd, Dd, Dd
Dd^Edp, Dd^Ftd, Dd^Ftd, Dd, Dd, Kd, Dd, Dd^Do, Ww, Ww, Ww, Wo, Ww, Ww, Ww, Ww, Ww, Ww, Dd, Dd^Ftd, Kd, Dd, Dd^Edpp, Dd, Dd^Ftd, Dd
Dd, Dd, Dd, Dd, Dd, Dd^Edpp, Kd, Dd^Edp, Dd, Ww, Ww, Ww, Ww, Ww, Ww, Ww, Dd^Vda, Dd, Dd^Ftd, Dd, Dd, Dd^Ftd, Dd^Edpp, Dd, Dd^Ftd, Dd
Dd^Edpp, Dd, Dd, Dd^Edp, Dd^Edpp, Dd, Dd^Ftd, Dd, Dd, Dd^Vda, Ww, Ww, Cd, Dd^Do, Dd, Dd^Edpp, Dd, Dd, Dd, Dd^Ftd, Kd, Dd^Ftd, Dd, Dd^Vda, Dd, Dd^Edp
Dd, Dd^Edp, Dd, Dd, Dd^Edpp, Dd^Ftd, Kd, Dd^Edpp, Dd^Edpp, Cd, Cd, 2 Kd, Cd, Cd, Rd^Vda, Dd, Rd, Rd, Rd, Rd, Rd, Rd, Rd, Rd, Rd, Rd
Rd, Dd^Edp, Rd, Dd, Rd, Rd, Rd, Rd, Rd, Rd, Rd, Cd, Rd, Rd, Rd, Rd, Rd, Rd, Dd^Ftd, Dd^Ftd, Kd, Dd, Dd, Dd, Dd^Ftd, Dd^Ftd
Dd^Edpp, Rd, Dd^Ftd, Rd, Dd^Edp, Dd^Ftd, Dd, Kd, Rd, Rd, Rd^Vda, Rd, Rd, Rd^Vda, Rd, Rd^Vda, Cd, Rd, Rd, Dd^Ftd, Dd, Dd, Dd^Ftd, Dd^Edpp, Dd, Dd
Dd, Dd, Dd^Ftd, Dd, Dd^Edpp, Dd^Vda, Rd, Rd, Rd, Kd, Rd, Rd, 1 Rd, Rd, Rd, Rd, Dd^Ftd, Rd, Rd, Dd, Dd^Ftd, Dd^Edp, Dd, Dd^Edpp, Dd, Dd
Dd^Edp, Dd^Ftd, Dd, Dd, Dd^Edpp, Dd^Ftd, Rd, Rd, Rd, Rd, Rd, Rd, Rd, Rd, Rd, Rd, Dd^Ftd, Dd, Rd, Dd^Ftd, Dd, Dd, Dd, Dd, Dd^Edp, Dd
Dd, Dd, Dd^Edpp, Dd, Dd^Ftd, Dd^Edp, Rd, Dd, Dd, Dd, Hd, Hd, Hd, Rd, Hd, Dd, Dd, Dd, Dd^Ftd, Rd, Rd, Dd, Dd, Dd, Dd^Edp, Dd
Dd^Edpp, Dd, Dd, Dd, Rd, Rd, Dd^Edp, Dd, Dd, Dd^Ftd, Dd^Ftd, Hd, Hd, Hd, Dd^Edp, Dd^Ftd, Dd^Edpp, Dd, Dd^Ftd, Dd^Ftd, Dd, Rd, Dd, Dd, Dd, Dd
