Dd, Dd, Dd, Dd, Dd^Edp, Dd^Dc, Dd^Es, Dd, Dd, Dd, Dd, Dd^Dc, Dd, Mdd, Mdd, Mdd, Mdd, Dd, Dd, Dd, Dd^Esd, Dd^Edpp, Dd, Dd, Dd^Esd, Mdd, Mdd, Mdd, Mdd, Mdd, Mdd, Mdd, Mdd, Mdd, Mdd, Dd, Mdd, Mdd, Mdd, Mdd, Mdd, Mdd, Mdd, Mdd, Mdd, Mdd, Mdd, Mdd^Xm, Mdd^Xm, Mdd^Xm, Mdd^Xm, Mdd^Xm, Mdd^Xm, Mdd^Xm, Mdd^Xm, Mdd^Xm, Mdd^Xm, Mdd^Xm, Mdd^Xm, Mdd^Xm, Mdd, Mdd, Mdd, Mdd, Mdd, Mdd
Dd, Dd, Dd, Dd, Dd, Dd, Dd^Edpp, Dd, Dd^Es, Dd, Dd, Dd^Edp, Dd, Mdd, Mdd, Mdd, Dd^Edp, Dd, Dd^Edp, Dd, Dd, Dd^Edp, Dd^Edp, Dd, Dd^Edpp, Dd^Ftd, Dd, Mdd, Mdd, Mdd, Mdd, Mdd, Mdd, Mdd, Dd^Edp, Mdd, Dd, Mdd, Mdd, Mdd, Dd^Esd, Mdd, Rd, Mdd, Dd, Mdd, Mdd, Mdd, Mdd, Mdd^Xm, Mdd^Xm, Mdd^Xm, Mdd^Xm, Mdd^Xm, Mdd^Xm, Mdd^Xm, Mdd^Xm, Mdd^Xm, Mdd, Mdd, Mdd, Mdd, Mdd, Mdd, Mdd, Mdd
Dd^Edpp, Dd, Dd^Edpp, Dd, Dd, Dd, Dd, Dd^Edpp, Dd, Dd, Dd, Dd, Mdd, Mdd, Mdd, Mdd, Dd, Dd, Dd, Dd, Dd, Dd, Dd, Dd, Dd, Dd^Edp, Dd, Dd, Dd, Mdd, Mdd, Mdd, Mdd, Dd^Ftd, Dd, Dd, Dd^Edp, Dd, Dd, Dd, Dd^Edpp, Dd^Esd, Rd, Dd^Edpp, Dd, Dd^Vdr, Dd^Edp, Mdd, Mdd, Mdd^Xm, Mdd^Xm, Mdd^Xm, Mdd^Xm, Mdd^Xm, Mdd^Xm, Mdd, Mdd, Mdd, Mdd, Mdd, Dd, Mdd, Dd, Mdd, Dd^Ftd, Dd^Ftd
Dd^Edpp, Dd^Edpp, Dd^Edp, Dd, Ce, Ce, Ce, Dd, Dd^Esd, Dd^Edp, Mdd, Dd^Esd, Mdd, Mdd, Mdd, Mdd, Dd, Dd^Edpp, Dd^Edp, Dd^Edp, Dd^Vdr, Dd^Ftd, Dd^Ftd, Dd^Ftd, Dd, Dd^Edpp, Dd, Dd^Edp, Dd^Edp, Dd^Es, Dd^Edp, Mdd, Dd, Dd, Dd, Dd, Dd^Edp, Dd^Edp, Dd, Dd, Dd, Dd^Edp, Rd, Rd, Dd, Dd, Dd^Es, Mdd, Mdd, Mdd^Xm, Mdd^Xm, Mdd^Xm, Mdd^Xm, Mdd^Xm, Mdd^Xm, Mdd, Mdd, Mdd, Dd, Dd, Dd, Dd^Edp, Dd, Dd, Dd^Ftd, Dd^Ftd
Dd^Edpp, Dd^Edp, Dd, Dd, Ce, 1 Ke, Ce, Dd, Dd, Mdd, Mdd, Mdd, Mdd, Mdd, Mdd, Dd, Dd, Dd, Dd^Ftd, Dd^Ftd, Ww, Dd^Ftd, Dd^Ftd, Dd^Ftd, Dd^Ftd, Dd, Dd^Edpp, Dd, Dd, Dd, Dd^Ftd, Dd^Vdr, Dd, Dd^Edp, Dd, Dd^Ftd, Dd, Dd^Edp, Dd, Dd, Dd, Rd, Dd^Edpp, Dd, Dd, Dd, Dd, Dd^Edp, Mdd, Mdd, Mdd, Mdd, Mdd^Xm, Mdd^Xm, Mdd, Mdd, Mdd, Mdd, Dd^Edp, Dd, Dd, Dd, Dd^Esd, Dd^Ftd, Dd^Ftd, Dd^Ftd
Dd, Dd, Dd, Dd, Dd^Edp, Ce, Dd, Dd, Mdd, Mdd, Mdd, Mdd, Mdd, Mdd, Dd, Dd, Dd^Ftd, Dd^Ftd, Dd^Ftd, Dd^Do, Ww^Ewf, Ww, Dd^Ftd, Dd^Edp, Dd^Ftd, Dd^Edpp, Dd^Edpp, Dd, Dd, Dd^Edp, Dd, Dd^Edp, Dd, Dd, Dd^Edp, Dd, Dd^Edp, Dd, Dd, Dd^Edp, Dd^Edp, Rd, Rd, Dd^Edp, Rd, Dd, Dd, Dd, Dd, Mdd, Mdd, Mdd, Mdd, Mdd, Mdd, Mdd, Mdd, Mdd, Dd, Dd^Edp, Dd, Dd^Edpp, Dd, Dd^Ftd, Dd^Ftd, Dd^Ftd
Dd, Dd, Dd^Edp, Dd, Dd, Dd^Edp, Dd, Dd, Mdd, Mdd, Mdd, Mdd, Dd, Dd^Ftd, Dd^Edp, Dd^Esd, Dd^Ftd, Dd^Ftd, Dd^Ftd, Ww^Ewl, Ww^Ewl, Ww, Dd^Ftd, Dd^Ftd, Dd^Ftd, Dd^Ftd, Dd, Dd, Rd, Dd, Rd, Dd, Rd, Hd, Dd, Dd, Dd, Dd, Dd, Dd, Rd, Rd, Rd, Rd, Rd, Rd, Rd, Dd, Dd^Edp, Mdd, Mdd, Mdd, Mdd, Mdd, Mdd, Dd^Edpp, Dd, Dd, Dd, Dd, Dd^Edpp, Dd^Edpp, Dd^Ftd, Dd^Ftd, Dd^Ftd, Dd^Ftd
Dd, Dd, Dd, Dd, Dd, Dd^Esd, Dd^Edpp, Dd^Vdr, Mdd, Mdd, Mdd, Dd, Dd^Edpp, Dd^Ftd, Dd, Dd, Dd^Ftd, Dd^Ftd, Dd^Ftd, Dd^Ftd, Dd^Ftd, Ww^Ewl, Dd^Vdr, Dd^Ftd, Dd^Edp, Dd^Ftd, Rd, Rd, Dd, Rd, Rd, Rd, Hd, Rd, Rd, Rd, Rd, Dd, Dd, Rd, Rd, Rd, Rd, Rd, Rd, Rd, Rd, Dd, Dd, Mdd, Mdd, Mdd, Mdd, Mdd, Mdd, Mdd, Dd, Dd^Edp, Dd^Edpp, Dd, Dd^Edp, Dd^Edp, Dd, Dd^Ftd, Dd^Ftd, Dd^Ftd
Dd^Dc, Dd^Edpp, Dd^Edp, Dd^Edpp, Dd^Edpp, Dd, Dd^Dc, Dd^Edp, Mdd, Mdd, Mdd, Dd, Dd^Edpp, Dd^Edp, Dd, Dd, Dd, Dd^Edpp, Dd, Dd^Ftd, Dd^Ftd, Dd^Ftd, Dd, Dd^Edpp, Dd^Edpp, Dd^Edp, Rd, Rd, Dd, Dd^Edp, Dd, Rd, Rd, Rd, Dd, Dd, Rd, Rd, Rd, Rd, Rd, Rd, Rd, Rd, Rd, Rd, Rd, Dd^Edp, Dd, Dd^Vdr, Mdd, Mdd, Mdd, Mdd, Mdd, Dd, Dd, Dd, Dd, Dd^Esd, Dd^Edp, Dd, Dd^Ftd, Dd^Ftd, Dd^Ftd, Dd^Ftd
Dd, Dd, Dd, Dd, Dd^Edp, Dd^Esd, Dd, Dd, Dd, Mdd, Mdd, Mdd, Dd^Edp, Dd, Dd^Edp, Dd, Dd, Dd^Edp, Dd, Dd^Ftd, Dd, Dd^Ftd, Dd, Dd, Rd, Dd, Rd, Rd, Dd^Es, Dd^Edp, Dd, Dd, Dd, Hd, Dd^Edp, Dd, Dd, Rd, Dd, Rd, Rd, Rd, Rd, Rd, Rd, Rd, Rd, Dd, Dd^Edpp, Dd^Esd, Dd^Edp, Mdd, Mdd, Mdd, Mdd, Dd^Es, Dd, Dd^Es, Dd^Edpp, Dd, Dd, Dd^Edp, Dd, Dd^Ftd, Dd^Vda, Dd^Ftd
Dd, Dd^Dc, Dd^Edp, Dd, Dd^Edp, Dd, Dd, Dd, Dd, Dd^Edpp, Dd^Edp, Dd, Dd, Dd, Dd, Dd^Edp, Dd^Edp, Dd^Edp, Dd^Edp, Dd, Dd, Dd, Rd, Rd, Rd, Rd, Dd, Dd, Dd, Dd, Dd^Vdr, Dd^Dc, Dd^Edp, Dd, Dd, Dd, Dd, Dd, Dd, Dd, Dd^Edp, Dd, Dd, Dd, Rd, Rd, Rd, Dd, Hd, Dd^Edp, Dd^Es, Dd^Edp, Dd^Edp, Dd, Cd, Dd, Dd, Dd^Esd, Dd^Edp, Dd, Dd, Dd, Dd^Edp, Dd, Ww, Ww
Dd^Ftd, Dd^Edp, Dd^Ftd, Dd, Dd, Dd, Dd, Dd, Dd^Ftd, Dd, Dd, Hd, Dd, Dd, Dd, Dd^Edpp, Rd, Dd, Dd, Dd^Edp, Dd, Rd, Rd, Rd, Dd^Edp, Dd, Dd, Dd, Mdd, Mdd, Mdd, Mdd, Mdd, Mdd, Mdd, Dd, Dd, Dd, Hd, Dd, Dd, Dd^Edp, Dd, Dd, Rd, Rd, Rd, Rd, Dd^Edpp, Dd, Dd, Dd, Dd^Edp, Dd, Kd, Rd, Dd^Vda, Dd^Edp, Dd, Dd^Edp, Dd^Ftd, Dd^Ftd, Dd^Edp, Dd, Dd^Vda, Wo
Dd, Dd, Dd^Edp, Dd, Hd, Dd^Edpp, Dd, Dd, Dd, Dd, Dd^Edpp, Dd, Dd^Edp, Dd, Dd^Edpp, Dd, Rd, Dd^Edp, Dd^Edp, Dd^Edp, Dd, Rd, Dd^Edpp, Dd^Edp, Dd, Dd, Mdd, Mdd, Mdd, Mdd, Mdd, Cdr, Mdd, Mdd, Mdd, Mdd, Dd^Esd, Dd^Edp, Dd, Dd, Dd^Es, Dd, Dd, Dd, Dd, Rd, Rd, Rd, Rd, Dd^Edpp, Rd, Rd, Rd, Dd^Edp, Cd, Rd, Rd, Dd, Dd^Edp, Dd^Ftd, Dd^Ftd, Dd^Ftd, Dd^Ftd, Dd^Ftd, Ww, Ww
Dd, Dd^Edpp, Dd^Ftd, Dd, Dd, Dd^Esd, Dd, Dd, Rd, Dd^Vdr, Rd, Dd, Dd, Dd^Edp, Rd, Rd, Rd, Dd^Edp, Rd, Rd, Rd, Dd, Dd^Edp, Dd, Hd, Mdd, Mdd, Mdd, Mdd, Cdr, Cdr, Cdr, Cdr, Cdr, Mdd, Mdd, Mdd, Dd, Dd^Edp, Dd, Dd, Dd, Dd, Dd, Dd, Dd, Dd, Dd, Dd^Edp, Rd, Dd, Rd, Rd, Rd, Rd, Rd, Rd, Dd^Edp, Dd, Dd^Ftd, Dd^Edp, Dd^Do, Ww, Ww, Rd, Rd
Dd, Dd, Dd^Edp, Dd, Dd^Edp, Dd, Rd, Rd, Rd, Rd, Dd, Rd, Rd, Rd, Dd, Dd^Edp, Rd, Rd, Dd, Rd, Rd, Rd, Dd^Edp, Dd, Mdd, Mdd, Mdd, Mdd, Rd, Dd^Ftd, Dd^Do, 2 Kdr, Dd^Vdr, Dd^Ftd, Dd^Ftd, Mdd, Mdd, Mdd, Hd, Dd, Dd^Ftd, Dd, Dd^Edp, Dd, Dd, Dd, Dd^Esd, Dd, Dd, Dd^Edp, Dd^Edp, Dd^Edp, Dd, Rd, Cd, Rd, Rd, Dd^Edpp, Rd, Dd, Rd, Rd, Rd, Rd, Dd^Edp, Rd
Dd, Dd, Dd^Esd, Dd, Dd, Rd, Rd, Rd, Dd, Rd, Dd^Edpp, Dd, Hd, Dd, Dd^Edp, Dd^Edpp, Hd, Dd, Dd^Dc, Dd^Edp, Rd, Dd^Es, Rd, Dd^Edp, Dd^Edp, Mdd, Hd, Rd, Dd^Ftd, Rd, Ww^Ewl, Ww^Ewl, Ww^Ewl, Dd^Ftd, Rd, Rd, Hd, Hd, Hd, Hd, Dd, Dd, Dd, Dd^Ftd, Dd^Dc, Dd^Edp, Dd^Edpp, Dd, Dd, Dd, Dd, Dd, Dd^Edp, Dd, Cd, Rd, Rd, Rd, Dd, Rd, Dd^Edp, Dd^Vda, Dd, Rd, Rd, Dd
Dd, Dd, Dd, Dd, Rd, Rd, Dd^Edpp, Dd, Dd, Dd, Dd, Dd^Edp, Hd, Hd, Hd, Dd^Esd, Dd, Dd^Edpp, Dd, Dd^Es, Rd, Rd, Dd, Rd, Rd, Hd, Mdd, Dd^Ftd, Dd^Ftd, Dd^Vdr, Dd^Ftd, Ww^Ewl, Dd^Ftd, Dd^Vdr, Rd, Rd, Hd, Hd, Mdd, Mdd, Mdd, Dd, Hd, Dd^Edp, Dd, Dd^Edpp, Dd, Dd^Edp, Dd, Dd, Dd^Es, Dd^Edpp, Dd^Edpp, Dd^Dc, 3 Kd, Rd, Rd, Rd, Dd^Edp, Dd, Dd^Esd, Dd, Dd^Ftd, Dd^Ftd, Dd^Ftd, Rd
Dd, Dd, Dd, Dd, Rd, Rd, Dd, Dd, Dd, Dd^Edp, Dd, Hd, Dd^Ftd, Hd, Hd, Hd, Hd, Dd^Edpp, Dd^Edpp, Rd, Rd, Rd, Dd, Mdd, Mdd, Mdd, Mdd, Mdd, Dd^Ftd, Dd^Ftd, Rd, Dd^Ftd, Dd^Ftd, Dd^Ftd, Rd, Rd, Mdd, Mdd, Mdd, Mdd, Mdd, Dd^Ftd, Dd, Dd, Dd, Dd, Dd^Edp, Dd, Dd^Ftd, Hd, Dd^Es, Dd, Dd^Edpp, Dd, Cd, Rd, Rd, Dd, Dd, Dd, Dd^Ftd, Dd, Dd^Ftd, Dd^Ftd, Dd^Ftd, Dd^Ftd
Dd, Dd, Dd^Edp, Dd^Ftd, Dd^Edp, Dd, Dd, Dd, Dd^Edpp, Dd^Edpp, Dd^Edpp, Hd, Hd, Dd^Ftd, Dd^Ftd, Dd^Ftd, Hd, Dd, Dd^Do, Rd, Rd, Dd, Dd, Mdd, Mdd, Mdd, Mdd, Mdd, Mdd, Mdd, Hd, Dd^Ftd, Mdd, Dd^Ftd, Mdd, Mdd, Mdd, Mdd, Mdd, Mdd, Mdd, Dd^Vdr, Dd^Edpp, Dd, Dd, Dd, Dd, Dd, Dd, Dd^Vdr, Dd, Dd^Es, Dd, Dd^Edp, Cd, Rd, Rd, Dd^Edp, Dd^Ftd, Dd^Edp, Dd^Ftd, Dd^Ftd, Dd^Edpp, Dd^Ftd, Dd^Edpp, Dd^Ftd
Dd, Dd, Dd, Dd, Dd^Edp, Dd^Ftd, Dd^Edpp, Dd, Dd^Edpp, Hd, Hd, Hd, Hd, Dd^Ftd, Dd^Ftd, Dd^Ftd, Hd, Rd, Rd, Rd, Rd, Rd, Dd^Edp, Dd, Dd^Edpp, Mdd, Mdd, Mdd, Mdd, Mdd, Mdd, Mdd, Mdd, Mdd, Mdd, Mdd, Mdd, Mdd, Dd^Esd, Mdd, Dd^Es, Dd, Dd^Edp, Dd, Hd, Dd, Dd, Dd^Esd, Rd, Dd, Dd, Dd^Edpp, Dd, Rd, Rd, Rd, Rd, Dd^Ftd, Dd^Ftd, Dd, Dd, Dd^Ftd, Dd, Dd^Edp, Dd^Edp, Dd
Dd, Dd^Edpp, Dd, Dd, Dd, Dd^Edp, Dd^Edpp, Dd^Edpp, Dd, Dd^Vdr, Hd, Dd^Ftd, Hd, Dd^Ftd, Hd, Dd^Ftd, Hd, Rd, Rd, Dd^Edp, Rd, Dd, Dd^Edpp, Dd^Edp, Dd, Dd^Edp, Hd, Dd^Edpp, Dd, Dd^Vdr, Dd^Edpp, Dd, Dd^Edp, Mdd, Hd, Mdd, Dd, Dd, Dd, Dd^Edpp, Dd, Dd^Esd, Dd^Edpp, Dd, Rd, Rd, Rd, Rd, Rd, Rd, Rd, Dd^Edp, Rd, Rd, Cd, Rd, Dd^Vda, Dd, Dd^Ftd, Dd^Ftd, Dd^Ftd, Dd, Dd^Edp, Dd, Dd^Edpp, Dd
Dd, Dd, Dd^Edp, Dd, Dd^Ftd, Dd^Ftd, Dd, Dd^Edpp, Dd, Dd, Dd, Dd^Edpp, Dd^Esd, Dd^Ftd, Dd^Ftd, Dd^Ftd, Hd, Rd, Rd, Dd^Edpp, Dd, Dd, Hd, Dd^Edp, Dd^Edp, Dd^Edp, Rd, Rd, Rd, Rd, Rd, Dd^Ftd, Dd, Rd, Dd^Edp, Dd^Edpp, Dd, Dd, Dd, Dd^Esd, Rd, Rd, Rd, Rd, Rd, Rd, Rd, Rd, Hd, Rd, Rd, Rd, Rd, Rd, Kd, Rd, Dd^Ftd, Dd^Ftd, Dd^Ftd, Dd^Ftd, Dd^Ftd, Dd^Ftd, Dd^Ftd, Dd^Edp, Dd, Dd^Edpp
Dd^Dc, Dd^Edpp, Dd, Dd^Edp, Dd, Dd, Rd, Dd, Dd, Dd^Do, Dd^Edpp, Dd, Dd, Dd^Edpp, Hd, Hd, Dd^Edp, Rd, Dd, Dd, Dd, Dd, Dd, Dd, Dd^Edpp, Dd, Rd, Rd, Dd^Dc, Dd, Rd, Dd^Edpp, Rd, Rd, Dd^Edp, Dd, Rd, Dd^Es, Rd, Rd, Rd, Rd, Rd, Rd, Rd, Rd, Rd, Dd, Dd, Dd, Dd, Dd, Dd, Dd, Cd, Rd, Dd^Ftd, Dd^Ftd, Mdd, Mdd, Mdd, Dd^Es, Dd^Ftd, Dd, Dd, Dd^Edpp
Dd, Dd, Dd, Dd, Dd, Dd, Rd, Rd, Rd, Dd, Dd, Dd^Edpp, Rd, Dd, Dd^Ftd, Hd, Dd, Dd, Rd, Rd, Rd, Rd, Rd, Dd, Rd, Rd, Rd, Dd^Esd, Rd, Hd, Hd, Rd, Dd^Dc, Rd, Rd, Rd, Rd, Rd, Rd, Rd, Dd, Hd, Dd^Edp, Rd, Rd, Rd, Rd, Dd^Edp, Dd^Edp, Dd^Esd, Dd, Dd, Dd, Dd^Edp, Mdd, Mdd, Mdd, Dd^Ftd, Mdd, Mdd, Mdd, Dd^Ftd, Dd^Ftd, Dd^Edp, Dd, Dd^Es
Dd, Dd, Dd^Esd, Dd, Rd, Rd, Rd, Rd, Rd, Dd, Dd^Ftd, Dd^Edp, Rd, Rd, Rd, Dd^Edp, Hd, Rd, Dd, Rd, Rd, Dd^Edp, Rd, Rd, Rd, Rd, Dd^Esd, Rd, Dd, Rd, Dd^Edp, Dd^Edpp, Dd^Es, Dd, Dd^Edp, Dd, Rd, Rd, Rd, Rd, Dd^Edpp, Dd, Dd, Rd, Rd, Rd, Dd, Dd, Dd^Edp, Dd^Es, Dd^Edp, Dd^Edp, Dd^Ftd, Mdd, Mdd, Mdd, Mdd, Mdd, Mdd, Mdd, Mdd, Mdd, Mdd, Dd^Dc, Mdd, Mdd
Dd, Dd, Dd^Edp, Dd, Dd, Rd, Rd, Rd, Rd, Rd, Rd, Rd, Dd, Dd^Edpp, Rd, Rd, Rd, Rd, Hd, Dd, Dd, Rd, Dd^Edp, Dd, Dd^Edp, Dd^Edp, Dd^Edp, Dd^Edp, Dd^Edp, Dd^Edp, Dd, Dd^Edp, Dd, Dd, Dd^Edpp, Dd, Dd^Edp, Rd, Rd, Rd, Rd, Rd, Rd, Rd, Dd, Dd, Dd, Dd, Dd^Edp, Dd, Dd^Edp, Dd^Edpp, Dd, Mdd, Mdd, Mdd, Mdd, Mdd, Mdd^Xm, Mdd^Xm, Mdd^Xm, Mdd, Mdd, Mdd, Mdd, Mdd
Dd, Dd^Ftd, Dd^Esd, Dd, Dd, Rd, Rd, Rd, Dd^Edp, Rd, Dd, Dd, Dd^Ftd, Dd, Dd^Ftd, Dd, Dd, Dd^Edp, Dd^Esd, Dd, Dd^Edp, Dd, Dd, Dd, Dd, Dd^Edp, Dd, Dd^Es, Mdd, Mdd, Mdd, Dd^Edpp, Hd, Dd, Dd, Dd^Edp, Dd^Edp, Rd, Rd, Rd, Rd, Rd, Dd, Dd, Dd, Dd^Edp, Dd, Dd, Dd^Es, Dd, Dd^Edp, Dd, Dd, Mdd, Mdd, Mdd, Mdd^Xm, Mdd^Xm, Mdd^Xm, Mdd^Xm, Mdd^Xm, Mdd^Xm, Mdd^Xm, Mdd^Xm, Mdd^Xm, Mdd
Dd, Dd, Dd, Dd, Dd, Dd, Dd^Dc, Dd, Dd, Dd, Dd, Dd, Dd, Dd, Mdd, Dd, Dd, Dd^Edp, Dd, Dd^Edpp, Dd, Dd, Dd, Dd^Edp, Dd, Dd, Dd^Vdr, Mdd, Mdd, Mdd, Mdd, Mdd, Mdd, Hd, Dd, Hd, Hd, Rd, Dd^Edpp, Rd, Dd, Dd^Edp, Mdd, Dd, Dd, Dd^Esd, Hd, Dd^Edp, Dd^Edp, Dd, Dd, Dd^Edp, Dd^Dc, Mdd, Mdd, Mdd, Mdd^Xm, Mdd^Xm, Mdd^Xm, Mdd^Xm, Mdd^Xm, Mdd^Xm, Mdd^Xm, Mdd^Xm, Mdd^Xm, Mdd
Dd^Edp, Dd^Edp, Dd, Dd^Edpp, Dd, Dd, Dd, Dd, Dd, Dd, Dd^Vdr, Dd, Mdd, Mdd, Mdd, Mdd, Mdd, Dd, Dd, Dd, Dd, Dd^Edpp, Dd, Dd, Mdd, Mdd, Mdd, Mdd, Mdd, Mdd, Mdd, Mdd, Mdd, Mdd, Dd, Mdd, Mdd, Hd, Dd^Edp, Dd, Mdd, Mdd, Mdd, Mdd, Mdd, Dd^Edp, Dd^Edp, Dd, Dd, Hd, Mdd, Mdd, Mdd, Mdd, Mdd, Mdd, Mdd^Xm, Mdd^Xm, Mdd^Xm, Mdd^Xm, Mdd^Xm, Mdd^Xm, Mdd^Xm, Mdd^Xm, Mdd^Xm, Mdd
Dd, Dd^Edp, Dd, Dd, Dd, Dd, Dd^Edpp, Dd, Dd^Esd, Mdd, Mdd, Mdd, Mdd, Mdd, Mdd, Mdd, Mdd, Dd, Dd^Edpp, Dd^Edpp, Dd, Dd^Ftd, Dd^Edp, Mdd, Mdd, Mdd, Mdd, Mdd, Mdd, Mdd, Dd^Ftd, Dd^Ftd, Dd^Ftd, Mdd, Dd, Mdd, Mdd, Hd, Mdd, Mdd, Mdd, Mdd, Mdd, Mdd, Mdd, Dd, Dd^Vdr, Mdd, Mdd, Mdd, Mdd, Mdd, Mdd, Mdd, Mdd, Mdd, Mdd^Xm, Mdd^Xm, Mdd^Xm, Mdd^Xm, Mdd^Xm, Mdd^Xm, Mdd^Xm, Mdd^Xm, Mdd^Xm, Mdd
Dd^Esd, Dd, Dd, Dd, Dd^Edpp, Dd, Mdd, Mdd, Mdd, Mdd, Mdd, Mdd, Mdd, Mdd, Mdd, Mdd, Mdd, Dd^Es, Mdd, Dd, Mdd, Mdd, Mdd, Mdd, Mdd, Mdd, Mdd, Mdd, Mdd, Mdd, Dd^Ftd, Dd^Ftd, Dd^Ftd, Dd^Vda, Dd^Do, Cd, Mdd, Mdd, Mdd, Mdd, Mdd, Mdd, Mdd, Mdd, Mdd, Mdd, Mdd, Mdd, Mdd, Mdd, Mdd, Mdd, Mdd, Mdd, Mdd, Mdd, Mdd^Xm, Mdd^Xm, Mdd^Xm, Mdd^Xm, Mdd^Xm, Mdd^Xm, Mdd^Xm, Mdd^Xm, Mdd, Mdd
Dd^Edp, Dd^Edpp, Dd, Dd, Dd, Dd, Dd, Mdd, Mdd, Mdd, Mdd, Mdd, Mdd, Mdd, Mdd, Mdd, Mdd, Mdd, Mdd, Mdd, Mdd, Mdd, Mdd, Mdd, Mdd, Mdd, Mdd, Mdd, Mdd, Mdd, Mdd, Dd^Ftd, Mdd, Mdd, Mdd, Mdd, Mdd, Mdd, Mdd, Mdd, Dd, Mdd, Dd, Mdd, Mdd, Mdd, Mdd, Mdd, Mdd, Mdd, Mdd, Mdd, Mdd, Mdd, Mdd, Mdd, Mdd, Mdd^Xm, Mdd^Xm, Mdd^Xm, Mdd, Mdd, Mdd, Mdd, Mdd, Mdd
