Ms^Xm, Ms^Xm, Ms, Ha, Ha^Fpa, Aa^Fpa, Aa^Fpa, Rb, Aa^Fpa, Ha^Fpa, Ms, Ms, Ms, Ms, Ms, Ms^Xm, Ms^Xm, Ms^Xm, Ms^Xm, Ms^Xm, Ms^Xm, Ms^Xm, Ms^Xm, Ms^Xm, Ms^Xm, Ms^Xm, Ms^Xm, Ms^Xm, Ms^Xm, Ms^Xm, Ms^Xm, Ms^Xm, Ms^Xm, Ms^Xm, Ms^Xm, Ms^Xm, Ms^Xm
Ms^Xm, Ms^Xm, Ms, Ms, Ha^Fpa, Aa^Fpa, Aa^Vea, Rb, Aa^Fpa, Aa^Fpa, Ms, Ms, Ms, Ms, Ms, Ms^Xm, Ms^Xm, Ms^Xm, Ms^Xm, Ms^Xm, Ms^Xm, Ms^Xm, Ms^Xm, Ms^Xm, Ms^Xm, Ms^Xm, Ms^Xm, Ms^Xm, Ms^Xm, Ms^Xm, Ms^Xm, Ms^Xm, Ms^Xm, Ms^Xm, Ms^Xm, Ms^Xm, Ms^Xm
Ms^Xm, Ms, Ms, Ms, Ha^Fpa, Ha^Fpa, Aa, Rb, Rb, Aa^Fpa, Ha^Fpa, Ms, Ms, Ms, Ms, Ms^Xm, Ms^Xm, Ms^Xm, Ms^Xm, Ms^Xm, Ms^Xm, Ms^Xm, Ms^Xm, Ms^Xm, Ms^Xm, Ms^Xm, Ms^Xm, Ms^Xm, Ms^Xm, Ms^Xm, Ms^Xm, Ms^Xm, Ms^Xm, Ms^Xm, Ms^Xm, Ms^Xm, Ms^Xm
Ms^Xm, Ms, Ms, Ms, Ms, Ha^Fpa, Aa, Cha, Rb, Aa, Aa, Ha, Ms, Ms, Ai, Ai, Ai, Ai, Ai, Ms^Xm, Ms^Xm, Ms^Xm, Ms^Xm, Ms^Xm, Ms^Xm, Ms^Xm, Ms^Xm, Ms^Xm, Ms^Xm, Ms^Xm, Ms^Xm, Ms^Xm, Ms^Xm, Ms^Xm, Ms^Xm, Ms^Xm, Ms^Xm
Ms^Xm, Ms, Ms, Ms, Ms, Ms, Aa, Cha, Rb, Rb, Aa, Aa, Ms, Ai, Ai, Ai, Wo, Ai, Ai, Ms^Xm, Ms^Xm, Ms^Xm, Ms^Xm, Ms^Xm, Ms^Xm, Ms^Xm, Ms^Xm, Ms^Xm, Ms^Xm, Ms^Xm, Ms^Xm, Ms^Xm, Ms^Xm, Ms^Xm, Ms^Xm, Ms^Xm, Ms^Xm
Ms^Xm, Ms^Xm, Ms^Xm, Ms, Ms, Ms, Ha^Vhha, Kha, Cha, Cha, Rb, Aa^Fpa, Ms, Ms, Ai, Ai, Wo, Wo, Wo, Ai, Ai, Ms^Xm, Ms^Xm, Ms^Xm, Ms^Xm, Ms^Xm, Ms^Xm, Ms^Xm, Ms^Xm, Ms^Xm, Ms^Xm, Ms^Xm, Ms^Xm, Ms^Xm, Ms^Xm, Ms^Xm, Ms^Xm
Ms^Xm, Ms^Xm, Ms^Xm, Ms, Ms, Ms, Ms, Aa, Aa, Aa, Rb, Aa^Fpa, Ms, Ai, Ai^Vaa, Wo, Wo, Ai, Ai, Ai, Ms^Xm, Ms^Xm, Ms^Xm, Ms^Xm, Ms^Xm, Ms^Xm, Ms^Xm, Ms^Xm, Ms^Xm, Ms^Xm, Ms^Xm, Ms^Xm, Ms^Xm, Ms^Xm, Ms^Xm, Ms^Xm, Ms^Xm
Ms, Ms, Ms, Ms, Ms, Ms, Aa^Fpa, Aa^Fpa, Rb, Rb, Aa^Fpa, Dd, Ai, Ai, Ai, Wo, Wo, Wo, Ai, Ai, Ms^Xm, Ms^Xm, Ms^Xm, Ms^Xm, Ms^Xm, Ms^Xm, Ms^Xm, Ms^Xm, Ms^Xm, Ms^Xm, Ms^Xm, Ms^Xm, Ms^Xm, Ms^Xm, Ms^Xm, Ms^Xm, Ms^Xm
Ms, Ms, Ms, Ms, Ms, Ms, Aa^Fpa, Aa^Fpa, Rb, Aa, Aa, Dd, Ai, Ai, Ai, Ai, Ai, Ai, Ww, Ms^Xm, Ms^Xm, Ms^Xm, Ms^Xm, Ms^Xm, Ms^Xm, Ms^Xm, Ms^Xm, Ms^Xm, Ms^Xm, Ms^Xm, Ms^Xm, Ms^Xm, Ms^Xm, Ms^Xm, Ms^Xm, Ms^Xm, Ms^Xm
Ms, Ms, Ms, Ms, Ms, Ms, Rb^Fpa, Rb^Fpa, Dd, Aa, Aa, Ha^Fpa, Ms, Ms, Ai, Ai, Ai, Ai, Ww, Ms, Ms^Xm, Ms^Xm, Ms^Xm, Ms^Xm, Ms^Xm, Ms^Xm, Ms^Xm, Ms^Xm, Ms^Xm, Ms^Xm, Ms^Xm, Ms^Xm, Ms^Xm, Ms^Xm, Ms^Xm, Ms^Xm, Ms^Xm
Ms, Ms, Ms, Ms, Ms, Ms, Ms, Rb, Rb, Dd, Dd, Aa^Vla, Ms, Ms, Ms, Ai, Ms, Ms, Ms, Ww, Ww, Ww, Ms^Xm, Ms^Xm, Ms^Xm, Ms^Xm, Ms^Xm, Ms^Xm, Ms^Xm, Ms^Xm, Ms^Xm, Ms^Xm, Ms^Xm, Ms^Xm, Ms^Xm, Ms^Xm, Ms^Xm
Ms^Xm, Ms, Ms^Xm, Ms, Ms, Ms, Ms, Ha, Ha, Dd, Aa, Aa, Ha, Ms, Ms, Ms, Ms, Ms, Ms, Ms, Ms, Ww, Ww, Ms^Xm, Ms^Xm, Ms^Xm, Ms^Xm, Ms^Xm, Ms^Xm, Ms^Xm, Ms^Xm, Ms^Xm, Ms^Xm, Ms^Xm, Ms^Xm, Ms^Xm, Ms^Xm
Ms^Xm, Ms^Xm, Ms^Xm, Ms, Ms, Ms, Ms, Hhd, Aa, Rb, Rb, Aa, Hhd, Hhd, Ha, Ms, Ms, Ms, Ms, Ms, Ms, Ww, Ww, Ms^Xm, Ms^Xm, Ms^Xm, Ms^Xm, Ms^Xm, Ms^Xm, Ms^Xm, Ms^Xm, Ms^Xm, Ms^Xm, Ms^Xm, Ms^Xm, Ms^Xm, Ms^Xm
Ms^Xm, Ms^Xm, Ms^Xm, Ms, Ms, Ms, Ms, Ha, Aa, Rb, Rb, Aa, Ha, Ha, Rb, Ha, Ha, Ms, Ha, Ms, Ms, Ms, Ww, Ms, Ww, Ms^Xm, Ms^Xm, Ms^Xm, Ms^Xm, Ms^Xm, Ms^Xm, Ms^Xm, Ms^Xm, Ms^Xm, Ms^Xm, Ms^Xm, Ms^Xm
Ms^Xm, Ms^Xm, Ms^Xm, Ms, Ms, Ms, Hhd, Ha, Aa^Fpa, Rb, Aa^Fpa, Rb, Dd, Rb, Rb, Rb, Ha, Ha, Ha, Ms, Ms, Ms, Coa, Ww, Ms, Ww, Ms^Xm, Ms^Xm, Ms^Xm, Ms^Xm, Ms^Xm, Ms^Xm, Ms^Xm, Ms^Xm, Ms^Xm, Ms^Xm, Ms^Xm
Ms^Xm, Ms^Xm, Ms^Xm, Ms, Ha, Hhd, Ha, Ha, Ha^Fpa, Aa^Fpa, Aa^Fpa, Rb, Dd, Dd, Rb, Ha, Ha^Fpa, Ha, Ha, Ms, Ms, Coa, 3 Koa, Coa, Ms, Ww, Ww, Ms^Xm, Ms^Xm, Ms^Xm, Ms^Xm, Ms^Xm, Ms^Xm, Ms^Xm, Ms^Xm, Ms^Xm, Ms^Xm
Ms^Xm, Ms^Xm, Ms^Xm, Ms, Ms, Hhd, Ha, Ha^Fpa, Ha^Fpa, Ha^Fpa, Aa, Aa, Rb, Rb, Rb, Ha, Ha^Fpa, Ha, Ha, Ms, Ms, Coa, Coa, Coa, Ms, Ms, Ww, Ww, Ms^Xm, Ms^Xm, Ms^Xm, Ms^Xm, Ms^Xm, Ms^Xm, Ms^Xm, Ms^Xm, Ms^Xm
Ms^Xm, Ms^Xm, Ms, Ms, Ms, Ha, Ha, Ha^Fpa, Ha^Fpa, Rb^Fpa, Ha^Fpa, Aa, Rb, Aa, Rb, Rb^Fpa, Ha^Fpa, Ha^Fpa, Ha, Ms, Ms, Ms, Ms, Ms, Ms, Ms, Ww, Ww, Ms^Xm, Ms^Xm, Ms^Xm, Ms^Xm, Ms^Xm, Ms^Xm, Ms^Xm, Ms^Xm, Ms^Xm
Ms^Xm, Ms, Ms, Ms, Ms, Ha, Ha, Ha^Fpa, Ha^Fpa, Rb^Fpa, Rb^Fpa, Aa, Rb, Rb, Aa, Rb^Fpa, Ha^Fpa, Ha^Fpa, Ha, Ms, Ms, Ms, Ms, Ms, Ms, Ms, Ww, Ms^Xm, Ms^Xm, Ms^Xm, Ms^Xm, Ms^Xm, Ms^Xm, Ms^Xm, Ms^Xm, Ms^Xm, Md^Xm
Ms^Xm, Ms, Ms, Ms, Ms, Ms, Ha, Ha^Fpa, Ha^Fpa, Ha^Fpa, Rb, Ha, Rb, 2 Aa^Vha, Aa, Aa^Fpa, Ha^Fpa, Ha, Ha, Ms, Ms, Ms, Ms, Ms, Ms, Ms, Ms, Ww, Ms, Ms^Xm, Ms^Xm, Ms^Xm, Ms^Xm, Ms^Xm, Md^Xm, Md^Xm, Md^Xm
Ms^Xm, Ms, Ms, Ms, Ms, Ms, Ha, Ha, Ha, Ha, Ha, Rb, Dd, Aa, Aa^Fpa, Aa^Fpa, Ha^Fpa, Ha^Fpa, Ha^Fpa, Ha^Fpa, Ha, Ms, Ha, Ms, Ms, Ms, Ms, Ww, Ms, Ms, Ms, Ms^Xm, Md^Xm, Md^Xm, Md^Xm, Md^Xm, Md^Xm
Ms^Xm, Ms^Xm, Ms^Xm, Ms, Ms, Ms, Ms, Ha, Ha, Ha, Ha, Rb, Rb, Dd, Aa, Aa^Fpa, Aa^Fpa, Ha^Fpa, Ha^Fpa, Ha^Fpa, Ha, Ha, Ha, Ha, Ha, Ms, Ms, Ww, Ms, Ms, Ms, Md^Xm, Md^Xm, Md^Xm, Md^Xm, Md^Xm, Md^Xm
Ms^Xm, Ms^Xm, Ms^Xm, Ms, Ms, Ms, Ms, Ms, Ms, Ha^Vhha, Hhd, Ha, Hhd, Re, Re, Re, Aa, Aa, Rb, Ha, Hhd, Hhd, Hhd, Ha, Ha, Ms, Ww, Ww, Ms, Ms, Ms, Md, Md, Md^Xm, Md^Xm, Md^Xm, Md^Xm
Ms^Xm, Ms^Xm, Ms^Xm, Ms^Xm, Ms, Ms, Ms, Ms, Ms, Ha, Hhd, Hhd, Ha, Aa, Aa, Re, Re, Re, Rb, Hhd, Ha, Hhd, Hhd, Ha, Hhd, Hhd, Ww, Ww, Ms, Ms, Md, Md, Md, Md^Xm, Md^Xm, Md^Xm, Md^Xm
Ms^Xm, Ms^Xm, Ms^Xm, Ms^Xm, Ms, Ms, Hhd, Ms, Ha, Ha, Ha, Hhd, Hhd, Hhd, Ha, Aa, Rb, Rb, Rb, Ha, Ha^Vhha, Ha, Hhd, Hhd, Hhd, Hhd, Ww, Md, Md, Md, Md, Md, Md, Md, Md, Md^Xm, Md^Xm
Md^Xm, Ms^Xm, Md^Xm, Ms, Md^Xm, Md, Hhd, Hhd, Ha, Ha, Ha, Ha, Ha, Hhd, Hhd, Ha, Rb, Rb, Rb, Hhd, Hhd, Hhd, Hhd, Hhd, Hhd, Hhd, Hhd, Ww, Md, Md, Md, Md, Md, Md, Md, Md, Md
Md^Xm, Md^Xm, Md^Xm, Md^Xm, Md^Xm, Md, Md, Hhd, Hhd, Ha, Hhd, Ha, Hhd, Hhd, Hhd, Hhd, Hhd, Rb, Rd, Rd, Rd, Hhd, Hhd, Hhd^Fp, Hhd^Fp, Hhd, Ww, Ww, Hhd, Md, Md, Md, Md, Md, Md, Md, Md
Md^Xm, Md^Xm, Md^Xm, Md^Xm, Md^Xm, Md^Xm, Md^Xm, Hhd, Hhd, Hhd, Hhd, Hhd, Hhd, Hhd, Hhd^Fp, Hhd^Fp, Hhd^Fp, Rd, Rd, Rd, Rd, Rd, Hhd, Hhd^Fp, Hhd^Fp, Hhd^Fp, Ha, Ww, Ww, Md, Md, Md, Md, Md, Md, Md, Md
Md^Xm, Md^Xm, Md^Xm, Md^Xm, Md^Xm, Md^Xm, Md^Xm, Md, Hhd, Hhd, Hhd, Hhd, Hhd^Fp, Hhd, Hhd^Fp, Hhd, Hhd, Hhd, Hhd, Aa, Aa, Rd, Aa, Hhd, Hhd, Hhd, Ha, Ha, Ha, Ww, Hhd, Md, Md, Md, Md, Md, Md
Md^Xm, Md^Xm, Md^Xm, Md^Xm, Md^Xm, Md^Xm, Md^Xm, Md, Md, Md, Md, Hhd, Hhd, Hhd^Fp, Aa^Fpa, Aa^Fpa, Hhd^Fp, Hhd, Hhd, Rd, Rd, Aa, Rd, Rd, Hhd, Aa^Fpa, Hhd, Ha, Ww, Ww, Hhd, Md, Md, Md, Md, Md, Md
Md^Xm, Md^Xm, Md^Xm, Md^Xm, Md^Xm, Md^Xm, Md^Xm, Md, Md, Md, Md, Md, Hhd, Ha, Hhd^Fp, Ha, Aa^Fpa, Hhd, Hhd, Hhd^Vhh, Rd, Rd, Cea, Rd^Ecf, Cea, Hhd, Hhd, Hhd, Ww, Hhd, Gll^Fp, Md, Md, Md, Md, Md, Md
Md^Xm, Md^Xm, Md^Xm, Md^Xm, Md^Xm, Md^Xm, Md^Xm, Md^Xm, Md^Xm, Md, Md, Md, Md, Aa^Fpa, Aa^Fpa, Hhd^Fp, Hhd^Fp, Hhd, Hhd, Hd, Rd, Rd, Cea, Cea, 1 Kea, Cea, Aa, Hhd, Gll^Fp, Ww, Ww, Md, Md, Md, Dd^Edpp, Md, Dd^Edpp
Md^Xm, Md^Xm, Md^Xm, Md^Xm, Md^Xm, Md^Xm, Md^Xm, Md^Xm, Md^Xm, Md^Xm, Md^Xm, Md, Md, Hhd, Dd^Edpp, Hhd^Fp, Hhd^Fp, Hhd, Hd, Hd, Hd, Rd, Rd, Aa, Rd^Ecf, Cea, Rd, Rd, Gll^Fp, Gll^Fp, Ww, Ww, Dd^Ftd, Dd^Edpp, Dd, Dd^Edpp, Dd^Edpp
Md^Xm, Md^Xm, Md^Xm, Md^Xm, Md^Xm, Md^Xm, Md^Xm, Md^Xm, Md^Xm, Md^Xm, Md^Xm, Md^Xm, Md^Xm, Dd^Edpp, Dd, Dd^Edpp, Hhd^Fp, Hhd^Fp, Hd, Hd, Hd, Hd, Hd, Rd, Hd, Rd, Rd, Rd, Rd, Ww, Ww, Ww, Dd^Ftd, Dd^Edpp, Dd^Edpp, Dd^Edpp, Re
Md^Xm, Md^Xm, Md^Xm, Md^Xm, Md^Xm, Md^Xm, Md^Xm, Md^Xm, Md^Xm, Md^Xm, Md^Xm, Md^Xm, Md^Xm, Dd, Dd, Dd^Edpp, Dd^Edpp, Dd^Edpp, Dd^Edpp, Dd, Dd, Dd, Dd, Hd, Hd, Rd, Rd, Rd, Rd, Ww, Dd^Ftd, Dd^Ftd, Dd^Edpp, Dd^Edpp, Dd, Dd^Edpp, Re
Md^Xm, Md^Xm, Md^Xm, Md^Xm, Md^Xm, Md^Xm, Md^Xm, Md^Xm, Md^Xm, Md^Xm, Md^Xm, Md^Xm, Md^Xm, Dd^Edpp, Dd^Edpp, Dd, Dd, Dd, Dd, Dd^Edpp, Dd, Dd, Dd, Dd, Dd, Dd^Vdt, Dd, Rd, Dd, Dd^Ftd, Dd^Edpp, Dd^Edpp, Dd, Dd, Dd, Dd, Dd^Edpp
Md^Xm, Md^Xm, Md^Xm, Md^Xm, Md^Xm, Md^Xm, Md^Xm, Md^Xm, Md^Xm, Md^Xm, Md^Xm, Md^Xm, Md^Xm, Md^Xm, Dd^Edpp, Dd^Edpp, Dd^Edpp, Dd, Dd^Edpp, Dd, Dd^Edpp, Dd, Dd^Edpp, Dd, Dd^Edpp, Dd, Dd, Dd, Dd^Edpp, Dd^Edpp, Dd^Edpp, Dd^Edpp, Dd^Edpp, Dd, Dd^Edpp, Dd^Edpp, Dd^Edpp
